	
praedictus	predictus
pertinenciis	pertinentiis
pertinentis	pertinentia
pertinentias	pertinenciis
prebentibus	presentibus
praesentibus	presentibus
praedictum	predictum
elemosina	elemosinam
eleemosinam	elemosina
elemosinas	elemosinam
helemosinam	elemosina
elimosinam	elemosinam
autoritate	auctoritate
auctoritatem	autoritate
actoritate	auctoritate
auctoritati	auctoritatis
inperpetuum	imperpetuum
imperpetuam	inperpetuum
concordiam	concordia
inspecturi	inspecturis
conuentuum	conuentum
subscripsit	subscripsi
subscripti	subscriptis
concesiset	concesise
medietate	medietatem
medietates	medietatis
uoluntatem	uoluntate
uoluntates	uoluntatis
asingnatis	asignatis
peruenerint	peruenerit
predictarum	predictorum
predicatorum	predictorum
donatione	donationem
donationes	donationis
donacionem	donationem
donationum	donationem
arcidiaconi	arcidiacono
arcidiaconos	arcidiaconus
arcideacono	arcidiacono
arcdiacono	arcidiacono
presentiam	presentium
praesentia	praesentis
quatraginta	quadraginta
ducentisimo	ducentesimo
ducentesimi	ducentesimo
monachorum	monacorum
conceserint	conceserit
conceserant	conceserunt
concesserunt	conceserunt
monasterio	monasterii
monasteriis	monasterii
monasteria	monasterii
incarnacione	incarnatione
religiosi	religiosis
religiosos	religiosis
religionis	religiosis
religiosas	religiosa
religiosus	religiosum
confirmauit	confirmaui
confirmari	confirmaui
confirmavi	confirmaui
iustitiariis	iusticiariis
iusticiarii	iusticiario
iusticiarios	iustitiariis
iusticiarius	iusticiariis
iusticariis	iusticiariis
servientibus	seruientibus
seruentibus	seruantibus
antecessorum	antecesorum
concedimus	concesimus
concessimus	concesimus
trinitati	trinitatis
confirmatus	confirmatum
recognoui	recognouit
recongnouit	recognouit
permaneant	permaneat
incarnacionis	incarnationis
permisionem	permisione
concesionem	concesione
concesiones	concesionis
concesioni	concesionis
confesione	concesionem
pontificatu	pontificatus
parisienses	parisiensis
parisiensi	parisiensis
exactionem	exactione
exactiones	exactione
confirmare	confirmase
confirmate	confirmata
confirmaset	confirmare
oflicialis	oficialis
uenerabili	uenerabilis
uenerabiles	uenerabilem
venerabilis	uenerabili
contraditione	contradictione
contradictioni	contradictionis
contradictionem	contradictione
territorio	territoria
arcidiaconis	arcidiaconus
arcidiaconum	arcidiaconus
archidiaconus	arcidiaconus
presbiteri	presbiter
presbitero	presbiter
hospitali	hospitalis
hospitales	hospitale
cluniacensi	cluniacensis
cluniacenses	cluniacensem
clugniacensis	cluniacensi
praesentis	presentis
archiepiscopus	arciepiscopus
arciepiscopis	arciepiscopus
arciepiscopum	archiepiscopus
arciepiscopos	arciepiscopo
ecclesiarum	eclesiarum
contingerit	contingeret
contigeret	contingeret
contigerint	contigerit
sempiternum	sempiternam
sempiterna	sempiternam
esterlingorum	sterlingorum
cepiscopis	episcopis
norwicensi	norwicensis
norwicenses	norwicensem
norwicencis	norwicensis
continentur	continetur
contineatur	continentur
excomunicationi	excomunicatione
petitione	petitionem
petitiones	petitionem
peticionem	petitionem
consuetudine	consuetudinem
consuetudines	consuetudinem
consuetudinum	consuetudinem
presentum	presentium
praesentium	presentium
capellanus	capelanus
potestatem	potestate
potestates	potestatis
warentizabimus	warantizabimus
garantizabimus	warantizabimus
redditibus	reditibus
prepositis	prepositus
prepositum	prepositus
prepositos	preposito
indiccione	indictione
inditione	indictione
arciepiscopi	arciepiscopo
archiepiscopo	arciepiscopi
arciepiscope	arciepiscopo
tenementi	tenementis
recognitionem	recognitione
recongnitione	recognitione
recognitiones	recognitionis
recognitioni	recognitionis
pertinente	pertinent
pertineant	pertinent
pertinenti	pertinentia
supradicti	supradicta
supradictus	supradictum
supradictas	supradicta
supradictos	supradictis
supradicto	supradicta
supradicte	supradicta
supradictam	supradictum
inpresione	impresione
impressione	impresione
impresionem	inpresione
uenditione	uenditionem
uenditiones	uenditionis
posesiones	posesionem
posesione	posesionem
posesionum	posesionem
pertineret	pertinere
apositionem	apositione
opositione	apositione
carnotensi	carnotensis
carnotenses	carnotensem
perciperet	perciperent
cancelarii	cancelario
cancelaria	cancelario
cancelarie	cancelario
cancelari	cancelario
sententiam	sententia
sententias	sententia
potuerimus	poterimus
indiuiduae	indiuidue
septuagesimi	septuagesimo
recongnouerunt	recognouerunt
posidendum	posidendam
posidenda	posidendam
posidendas	posidendam
possidendam	posidenda
testimonii	testimonio
testimonia	testimonio
presentatione	presentationem
quibuscunque	quibuscumque
pontificalis	pontificali
pontificale	pontificalem
hereditatem	hereditate
hereditates	hereditatis
haereditate	hereditatem
ordinatione	ordinationi
ordinationes	ordinationem
antecesores	antecesoris
antecesori	antecesor
benedictio	benedicto
molendinos	molendinis
precepimus	recepimus
recipimus	recipiemus
nonogesimo	nonagesimo
exelentisimo	excelentisimo
excelentisimi	excelentisimo
excelentisime	excelentisimo
cantuariensi	cantuariensis
clamantiam	clamantia
latitudinem	latitudine
constitutis	constituti
constitutum	constituta
constitutos	constitutus
constitutas	constituta
contingant	contingunt
religiosarum	religiosorum
quadragesima	quadragesimo
quadragesime	quadragesimo
quatragesimo	quadragesimo
apenditiis	apendiciis
appendiciis	apendiciis
apendicias	apenditiis
perueniret	peruenire
posuerunt	aposuerunt
aposuerint	posuerint
episcopalia	episcopali
episcopalis	episcopali
episcopale	episcopalem
apostolica	apostolice
apostolici	apostolice
apostolico	apostolice
remisionem	remisione
remissione	remisionem
quoscumque	quocumque
quodcumque	quocumque
libertate	libertatem
libertates	libertatem
libertatum	libertatem
compositione	compositionem
conpositionem	compositionem
compositiones	compositionis
recongnitio	recognitio
quinquagenta	quinquaginta
octagesimo	octuagesimo
sustentatione	sustentationem
lincolniensi	lincolniensis
lincoliensis	lincolniensi
lincolnienses	lincolniensem
lincolnensis	lincolniensis
donationi	donationis
donacionis	donationis
solutionem	solutione
solutiones	solutionis
ordinariam	ordinarium
defendimus	defendemus
presenciam	presencia
controuersiam	controuersia
controuersie	controuersia
controuersias	controuersiis
contrauersia	controuersia
molendini	molendinis
cirograpis	cirograpi
cirografpi	cirografi
consueuerant	consueuerunt
consueuerint	consueuerunt
hereditarie	hereditario
hereditaria	hereditario
hereditarii	hereditariis
hereditagio	hereditario
dignitatem	dignitate
dignitates	dignitatis
predecesorem	predecesorum
predecessorum	predecesorum
longitudinem	longitudine
posidebant	posidebat
possideant	possideat
firmitate	firmitatem
constituta	constituti
constitui	constituit
constitute	constituti
constituto	constituo
constitutio	constituti
diligentem	diligenter
diligentes	diligenter
senonensi	senonensis
senonenses	senonensem
dingnemini	dignemini
confirmato	confirmata
confirmatis	confirmatio
inpedimento	impedimento
impedimenta	impedimento
aurelianensi	aurelianensis
aurelianenses	aurelianensi
eboracensi	eboracensis
eboracenses	eboracensem
uniuersitati	uniuersitatis
universitatis	uniuersitatis
naiuitatis	natiuitatis
aduocationem	aduocatione
aduocationes	aduocationis
advocatione	aduocatione
conuentione	conuentionem
conuentiones	conuentionis
contentionem	conuentione
conuentionum	contentionem
securitate	securitatem
tesaurarii	tesaurario
tesauraria	tesaurarium
tesaurarie	tesaurario
tesaurarios	tesaurarius
nihilominus	nicilominus
nichilominus	nicilominus
remiserint	remiserunt
confirmatione	confirmationem
confirmationes	confirmationis
confirmacionem	confirmationem
confirmationum	confirmationem
benedictione	benedictionem
benedictiones	benedictionis
orientalis	orientali
prepositi	prepositis
niuernensi	niuernensis
niuernenses	niuernensem
pentecostes	pentecosten
pentecoste	pentecosten
pentecostem	pentecosten
promiserant	promiserat
promiserint	promiserunt
cepiscoporum	episcoporum
litterarum	literarum
misericordiam	misericordia
misericordie	misericordia
composito	compositio
conpositio	compositio
aniuersarii	aniuersario
aniuersaria	aniuersario
teodbaldus	teobaldus
teolbaldus	teobaldus
garantizabunt	warantizabunt
warentizabunt	garantizabunt
clamauerint	clamauerit
calumpniam	calumpnia
calumpnias	calumpnia
omnipotenti	omnipotentis
omnipotentia	omnipotentis
tendentes	atendentes
promitente	promitentes
percipient	percipiet
seruiente	seruientes
seruientis	seruienti
seruientem	seruientes
servientes	seruientes
patronatu	patronatus
patronatum	patronatus
percipiendas	percipiendos
percipiendis	percipiendos
percipiendo	percipiendis
conditionem	conditione
condicione	conditionem
conditiones	conditionis
conditioni	conditionis
condictione	conditione
premisarum	premisorum
promisorum	premisorum
acquitanie	aquitanie
occidentem	occidente
uicecomite	uicecomiti
uicecomitis	uicecomiti
procuratores	procuratorem
procuratore	procurator
procuratorum	procuratorem
predecesores	predecesoris
predecesori	predecesor
predecessoris	predecesores
uendidiset	uendidisent
senescalos	senescalus
perseuerent	perseueret
perseveret	perseueret
perseuerat	perseueret
reginaldum	reginaldus
raginaldus	rainaldus
reinaldus	reginaldus
reginaudus	reinaudus
inconcusam	inconcusum
inconcussa	inconcusa
fidelitate	fidelitatem
fidelitates	fidelitatis
bartolomeo	bartolomei
bartolomew	bartolomei
competente	competenter
competentis	competenti
conpetenti	competenti
competentia	competenti
beneficii	beneficiis
septembri	septembris
procuratori	procuratores
procuratur	procuratum
natiuitate	natiuitatem
occidentali	ocidentali
ocidentale	occidentali
ocidentalis	ocidentali
parocialis	parocianis
parocialia	parociali
dominationis	dominationi
dominatione	dominationem
clamationem	clamatione
clamationi	clamationis
saecularibus	secularibus
ordinationis	ordinationi
exscambium	excambium
gisleberto	gileberto
asiamentis	aisiamentis
eisiamentis	asiamentis
orientale	orientalem
prouideret	prouiderent
presumpserint	presumpserit
presumserit	presumpserit
praesumpserit	presumpserit
autisiodorensi	autisiodorensis
altisiodorensis	autisiodorensis
autisiodorenses	autisiodorensem
gloucestria	gloucestrie
glocestrie	gloucestria
gloucestre	gloucestr
spontaneam	spontanea
gilebertus	gilbertus
gilibertus	filibertus
cancelarium	cancelaria
purificationes	purificationem
bartolomeum	bartolomeus
bertolomeus	bartolomeus
expedicione	expeditione
expeditionem	expedicione
expeditiones	expeditionis
reclamationem	reclamatione
concedentes	concedente
concedent	concedente
dilectarum	dilectorum
instanciam	instantiam
instantia	instantiam
obedientia	obedientiam
obedienciam	obedientia
hobedientiam	obedientiam
adquietabimus	acquietabimus
aquietabimus	acquietabimus
retinemento	retenemento
reuerentia	reuerentiam
reuerenciam	reuerentia
reverentiam	reuerentia
uenerabile	uenerabilem
venerabilem	uenerabilem
promisimus	promitimus
corporale	corporalem
deuotionem	deuotione
oblationem	oblationum
oblatione	oblationes
oblationis	oblationes
camerariis	camerarius
pertinentes	pertinente
pertinentem	pertinente
necesariam	necesarium
necesarias	necesariis
necessaria	necesaria
herebertus	herbertus
libertatis	libertates
libertati	libertates
liberatis	libertates
priuilegia	priuilegio
priuilegii	priuilegiis
privilegio	priuilegii
lugdunensi	lugdunensis
lugdunenses	lugdunensem
prenominati	prenominatis
prenominatus	prenominatis
prenominatas	prenominatis
prenominatos	prenominati
solemniter	solempniter
septimana	septimanas
septimanis	septimanas
septimanam	septimanas
satisfactionem	satisfactione
satisfaccione	satisfactionem
confirmationi	confirmationis
confirmacionis	confirmationis
tantummodo	tantumodo
testamento	testamenti
testamentis	testamenti
testamenta	testamenti
contentionis	conuentionis
conuentioni	conuentionis
quoscunque	quocunque
quodcunque	quocunque
concessionis	concesionis
confesionis	concesionis
ouentiones	obuentiones
obseruaret	obseruarent
exoniensi	exoniensis
compositioni	compositionis
dilationem	dilatione
dilationes	dilationis
parociani	parocianis
parocianos	parocianis
parocianus	parocianis
exequtores	executores
executorem	executorum
executoris	executores
cexecutores	executores
exsecutores	executores
executore	executores
utilitate	utilitatem
utilitates	utilitatem
rationibus	orationibus
aethelstan	athelstan
ethelstani	ethelstan
ethelstane	ethelstan
percipiant	percipient
percipiat	percipient
percipiunt	percipient
aniuersarius	aniuersarii
consecrationes	consecrationem
consecrationi	consecrationis
quascumque	quacumque
quamcumque	quacumque
camerarium	camerarius
cluniacense	cluniacensem
clugniacensem	cluniacensem
quemcumque	quecumque
adstantibus	astantibus
difficultate	dificultate
cujuslibet	cuiuslibet
consencientibus	consentientibus
corporalis	corporali
dignoscitur	dinoscitur
dinoscimur	dinoscitur
dinoscatur	dinoscitur
exceptione	exceptioni
sacrosancti	sacrosancte
necesitatem	necesitate
necesitates	necesitatis
necesitati	necesitatis
necessitate	necesitatem
persoluet	persoluent
persoluant	persoluat
tenebantur	tenebatur
potestati	potestatis
conquieui	conquieuit
cabilonensi	cabilonensis
kabilonensis	cabilonensis
communiter	comuniter
nuncupantur	nuncupatur
arcipresbiteri	arcipresbiter
arcipresbitero	arcipresbiter
contumacia	contumaciam
contumacias	contumaciam
contumatiam	contumaciam
iherusalem	ierusalem
hierusalem	ierusalem
lingonensi	lingonensis
sacramenta	sacramento
sacramenti	sacramento
suficientem	suficienter
suficientes	suficienter
sufitienter	suficienter
episcopatu	episcopatus
episcopatum	episcopatus
episcopatui	episcopatus
eclesiastica	eclesiasticam
eclesiasticum	eclesiasticam
eclesiasticas	eclesiasticis
ecclesiasticam	eclesiasticum
excelencia	excelentia
excelentie	excelencia
excelentiam	excelencia
exelentia	excelentia
excelenti	excelentia
redemptionem	redemptione
redempcione	redemptione
discordiam	discordia
discordias	discordiis
uenditioni	uenditionis
dimiserint	dimiserit
diuiserunt	dimiserunt
margaretam	margareta
marguareta	margareta
precentor	precentore
precentorem	precentore
precentori	precentoris
preceptore	precentorem
wintoniensi	wintoniensis
wintaniensis	wintoniensis
wyntoniensis	wintoniensis
competentem	competenter
competentes	competenter
conpetenter	competentem
uertebantur	uertebatur
electione	electionem
herefordensi	herefordensis
herfordensis	herefordensi
temptaverit	temptauerit
atemptauerit	temptauerit
temptauerint	atemptauerit
latrocinio	patrocinio
patrocinia	patrocinio
peccatorum	pecatorum
beneficium	benefitium
seruientum	seruiendum
servientium	serviencium
prenominato	prenominati
prenominata	prenominati
prenominate	prenominati
quictauerunt	quitauerunt
quitauerant	quitauerat
imposterum	inposterum
garantizare	warantizare
warentizare	garantizare
warantizaret	warantizare
obseruandam	obseruanda
obseruando	obseruanda
obseruandas	obseruandis
obseruande	obseruanda
quandocunque	quandocumque
salvatoris	saluatoris
saluatori	saluatoris
presbyteri	presbyter
presbytero	presbyter
prescriptam	prescripta
prescripte	prescripta
prescripti	prescriptis
prescriptas	prescriptis
prescripto	prescripta
manifesta	manifestam
manifestum	manifestam
manifestas	manifestam
manifestat	manifestam
presbiterium	presbiterum
defenderet	defendere
cuiuscunque	cuiuscumque
cujuscumque	cuiuscumque
gualterius	galterius
gaulterius	gauterius
interfuerint	interfuerunt
interfuerant	interfuerunt
constabularii	constabulario
constabularios	constabularius
conestabulario	constabularii
possidebat	posidebat
prioratuum	prioratum
aecclesiam	aecclesiae
dunelmensi	dunelmensis
dunolmensis	dunelmensi
dunelmenses	dunelmensem
godefridum	godefridus
godefredus	godefridus
godfridus	godefridus
gotefridus	godefridus
gisleberti	gileberti
atestantur	testantur
reuertentur	reuertetur
reuertatur	reuertentur
iurisdictione	iurisdictionem
iurisdictionis	iurisdictioni
iuridictioni	iurisdictionis
iurisditioni	iuridictioni
antiquitas	antiquitus
cirografum	cirograpum
cirographum	cyrographum
optinebant	optineant
confirmaverunt	confirmauerunt
confirmauerint	confirmauerit
tradiderint	tradiderunt
temporalia	temporalis
temporali	temporalis
requisitione	requisitionem
subscriptas	subscriptis
subscriptam	subscripta
subscripto	subscripta
subscripte	subscripta
consignavi	consignaui
consignari	consignaui
consignauit	consignaui
confirmat	confirmata
confirmatam	confirmatum
confirmatas	confirmata
medietati	medietatis
antecessoribus	antecesoribus
redendarum	redendorum
forinsecus	forinsecis
diminutionem	diminutione
compeleret	compelerent
decrevimus	decreuimus
piscuariis	piscariis
foeliciter	feliciter
apelationi	apelatione
apelationem	apelatione
apelationes	apelationi
ordinandam	ordinanda
ordinandus	ordinandum
spiritalibus	spiritualibus
antedicti	antedictis
antedictus	antedictam
antedictos	antedicto
antedictas	antedicta
deuotioni	deuotionis
devotionis	deuotionis
sepedictis	sepedictus
guarantire	garantire
garantiret	garantirent
particula	particulam
particulas	particulam
nominantur	dominantur
rationabile	rationabilem
rationabilis	rationabili
rationabilia	rationabili
cimeterium	cimiterium
penitencia	penitentia
penitentiam	penitentia
penitentie	penitencia
poenitentia	penitentia
penitentias	penitentiis
tesaurarium	tesaurarius
tesaurariis	tesaurarius
iustitiario	iustitiariis
iusticiari	iusticiare
ewangeliste	euangeliste
euuangeliste	euangeliste
signauimus	asignauimus
asignabimus	asignauimus
privilegium	priuilegium
particulis	articulis
presentarunt	presentabunt
quitatione	quitationem
quietationem	quitationem
equitationem	quitationem
inquisitione	inquisitionem
inquisitiones	inquisitionem
instrumento	instrumenta
instrumenti	instrumentis
curauerunt	iurauerunt
iurauerint	iurauerit
pertinencia	pertinenciis
matisconensi	matisconensis
perseuerase	perseuerare
atestationes	atestatione
petronilam	petronila
quarterum	quarterium
quartarium	quarterium
buticulario	buticularii
reclamaret	reclamare
principium	principum
diligentia	diligenti
suscipimus	suscepimus
siluanectensi	siluanectensis
siluanetensis	siluanectensis
siluanectenses	siluanectensem
coroboraui	corroboraui
corroboravi	corroboraui
privilegiis	priuilegii
institutum	institutus
institutis	institutio
proueniente	prouenientes
prouenientem	prouenientes
prouenientis	prouenientes
deforciantes	deforciantem
deforcientem	deforciantem
colecestria	colecestrie
colcestrie	colecestria
pertineat	pertinebat
pertinebant	pertinebat
pertinebit	pertinebat
venerabilium	uenerabilium
predecesore	predecesor
receperint	receperit
preceperunt	receperunt
receserunt	deceserint
receperant	receperat
religione	religionem
aeternaliter	eternaliter
genetricis	genitricis
genitrici	genitricis
personatum	personatus
inominatis	nominatis
recompensatione	recompensationem
lincolnien	lincolnie
conseruent	conseruet
proprietate	proprietatem
deliberationem	deliberatione
cisterciensi	cisterciensis
cistercienses	cisterciensis
sepultura	sepulturam
sepulturas	sepulturis
haereditatis	hereditatis
lundoniensis	londoniensis
londoniensi	lundoniensis
londiniensis	londoniensis
adquietabunt	acquietabunt
aquietabunt	acquietabunt
constructionem	constructione
construccione	constructione
sentenciam	sentencia
sentencias	sentencia
continentes	continentem
continente	contingente
contingentem	contingente
prestationem	prestatione
prestationes	prestationis
contingere	contingeret
seruituris	seruitutis
servitutis	seruitutis
seruituti	seruitutis
dignoscuntur	dinoscuntur
requisitis	irequisitis
ordinabimus	ordinauimus
benedictum	benedictus
universorum	uniuersorum
emendaverit	emendauerit
emendauerint	emendaverit
procuratione	procurationem
procurationes	procurationis
procurationum	procurationem
dimisionem	diuisionem
scripturam	scriptura
scripturas	scripturis
predecessoribus	predecesoribus
interposito	interposita
interpositam	interposita
interpositas	interpositis
sacerdotes	sacerdotis
sacerdoti	sacerdotis
sacerdotii	sacerdotis
uoluntati	uoluntatis
voluntatis	uoluntatis
molendinarii	molendinario
posesionis	posesiones
posesioni	posesiones
appellantur	appellatur
requisitum	requisitus
detentione	retentione
retentionem	detentione
prenominatum	prenominatus
prenominatam	prenominatus
iuridictionem	iurisdictione
iurisdictiones	iurisdictionem
procuratoris	procuratores
procuratorio	procuratores
procuratorii	procuratores
procuratoriis	procuratores
procuratorias	procuratores
turonensis	turonenses
purificatione	purificationem
purificationum	purificationem
warantizationem	warantizatione
stabilitatem	stabilitate
stabilitati	stabilitatis
facultatem	facultates
facultate	facultates
adjacentibus	adiacentibus
eleemosine	elemosina
helemosine	elemosina
fideiusorem	fideiusores
fideiiusores	fideiusores
protectionem	protectione
presbiteris	presbiteri
presbiteros	presbiteri
presbiterii	presbiteri
integritatem	integritate
questione	questionem
questiones	questionis
anatemati	anatematis
anathematis	anatematis
apostolicam	apostolica
apostolicum	apostolica
apostolicas	apostolici
censeatur	censeantur
censentur	censeantur
belomontem	belumontem
responderet	respondere
responderi	respondere
sepedictum	sepedictus
sepedictos	sepedicto
sepedictas	sepedicta
administratione	administrationem
constitit	constituit
constituat	constituit
constituet	constituit
uacauerint	uacauerit
notingeham	notingham
rediturum	redditurum
amicabilis	amicabili
celararius	celerarius
celerarium	celerarius
incorigibiles	incorigibilis
persoluendos	persoluendis
persoluendas	persoluenda
persoluendi	persoluenda
singularum	singulorum
recipienti	recipiendi
recipiente	recipientes
kingeston	kingestone
kingestune	kingestone
kingistone	kingestone
completorium	completorum
lancastre	lancastrie
lancastria	lancastriam
iosceranus	ioceranus
iocerandus	ioceranus
ecclesiae	aecclesiae
aecclesia	aecclesiae
aecclesie	aecclesiae
aecclesias	ecclesias
aeclesiae	aecclesiae
roborandum	roborandam
roborandas	roborandam
roboranda	roborandam
christiane	cristiano
uendiderint	uendiderit
uendiderant	uendiderunt
continentibus	contingentibus
questioni	questionis
conseruari	conseruare
conservare	conseruare
cardinali	cardinalis
cardinales	cardinalem
posidebunt	posidebant
posiderunt	posiderent
rationabiles	rationabilem
ceterique	ceterisque
ceterosque	ceterisque
autoritatis	auctoritatis
renuntiantes	renunciantes
westmonasterio	westmonasterii
subiectionem	subiectione
subjectione	subiectione
obseruatione	obseruationem
reuerendis	reuerendus
ewangeliis	euangeliis
euuangeliis	euangeliis
euangelii	euangeliis
confessoris	confesoris
confesori	confesoris
confesores	confesoris
confirmandum	confirmandam
confirmanda	confirmando
confirmandas	confirmandam
wigornensis	wigorniensis
wigorniensi	wigornensis
laurentium	laurentius
subscriptos	subscriptis
participem	participes
gilebertum	gilbertum
burgentium	burgensium
percipiendam	percipiendum
paternitatis	paternitati
paternitate	paternitatem
defensionem	defensione
defensiones	defensionis
defensioni	defensionis
defentione	defensione
obedientie	obedientia
obediencie	obedientia
glecestria	gloucestria
glecestre	glecestrie
supradictarum	supradictorum
eclesiastici	eclesiastica
eclesiasticos	eclesiastica
ecclesiasticis	eclesiasticis
dorobornensis	dorobernensis
dorouernensis	dorobernensis
dorobernensi	dorobernensis
dorovernensis	dorobernensis
concederet	concedere
concederem	concedere
contrariam	contrarium
contrarius	contrarium
interdicto	interdicti
interdici	interdicti
interdicta	interdicti
confitentes	confidentes
confidenter	confidentes
quantitate	quantitatem
imobilibus	mobilibus
perseuerant	perseuerans
territorium	teritorium
inpetratis	impetratis
impetratas	impetrata
cexecutoribus	executoribus
exequtoribus	executoribus
clementiam	clementia
procreati	procreatis
procreatos	procreato
pontifici	pontificis
pontifices	pontifice
confirmatur	confirmatum
emendatione	emendationem
emendationes	emendationis
obliuionem	obliuione
cristianam	cristiana
christiana	cristiano
contuliset	contulise
obligationem	obligatione
obligationes	obligationis
obligationi	obligationis
necesarios	necesariis
necessariis	necesariis
necesarii	necesariis
qualitercunque	qualitercumque
aethelsige	athelsige
prouentium	prouentuum
prouentum	prouentuum
reuerendam	reuerenda
uicariarum	uicariorum
uiuariorum	uicariorum
saecularium	secularium
beneficiorum	benefitiorum
existentes	existente
existentem	existente
persolueret	persoluere
persoluero	persoluere
consulimus	consulibus
pastorali	pastoralis
frideswite	frideswide
fredeswide	frideswide
frideswida	frideswide
fridesuide	frideswide
friteswide	frideswite
frideswid	frideswide
uiuentibus	uidentibus
bidentibus	uidentibus
celsitudinis	celsitudini
celsitudine	celsitudinem
euuangelia	euangelia
euangelica	euangelia
anuntiationis	anunciationis
petitionis	petitioni
presentabit	presentauit
inuenirent	inueniret
guarnerius	garnerius
dignitati	dignitatis
eclesiastico	eclesiastica
eclesiastice	eclesiastica
ecclesiastico	eclesiastice
rediderint	rediderunt
crediderunt	rediderunt
salopesberia	salopesberie
quictauimus	quitauimus
gubernatur	gubernantur
teritoriis	teritorii
dispositione	dispositionem
institutione	institutionem
institutiones	institutionis
rotomagensi	rotomagensis
rotomagenses	rotomagensem
defecerit	defecerint
defecerunt	defecerint
quemcunque	quecunque
quaecunque	quacunque
uenditoris	uenditores
infirmarie	infirmari
infirmaria	infirmari
infirmario	infirmari
infirmarii	infirmari
solicitudinem	solicitudine
solicitudini	solicitudinis
solicitudines	solicitudinis
sollicitudine	solicitudine
deceserint	deceserit
residentia	residentiam
residentie	residenti
residentis	presidentes
concurentes	concurente
concurrente	concurentes
instituemus	instituimus
iudicialis	iudiciali
sacrosancta	sacrosancte
sacrosancto	sacrosancte
festiuitatem	festiuitate
obseruentur	obseruetur
obseruatur	obseruatum
colatione	colationem
colationes	colationis
presentari	presentare
presentase	presentare
presentate	presentante
presentaret	presentase
arcidiaconali	arcidiaconalia
arcidiaconalis	arcidiaconalia
uulgaliter	uulgariter
hospitalem	hospitale
percipiendi	percipiendis
percipienda	percipiendis
percipiend	percipient
largitionem	largitione
contulerint	contulerunt
contulerant	contulerat
herefordia	herefordie
hertfordie	herefordie
herfordie	herefordie
castelionem	castelione
inpetrandis	impetrandis
exequtorum	executorum
perticatam	perticatas
perticata	perticatas
perticatis	perticatas
couentrensi	couentrensis
conuentrensis	couentrensi
solutioni	solutionis
damnabiliter	dampnabiliter
successorem	successores
uidebantur	uidebatur
quascunque	quacunque
quamcunque	quacunque
consolidavi	consolidaui
difinitiua	difinitiue
prescriptum	prescriptam
rescriptum	prescriptam
prescriptus	prescriptis
inconcusse	inconcuse
sacerdotem	sacerdotes
considerationem	consideratione
principalis	principales
principale	principales
principalia	principali
ceterorumque	ceterarumque
caeterarumque	ceterarumque
firmaverunt	firmauerunt
afirmauerunt	firmauerunt
ascentionis	ascensionis
asensionis	ascentionis
clamabimus	clamauimus
inferentes	inherentes
sustineret	sustinerent
religioso	religiosos
traditionem	traditione
diligentibus	diligentius
disciplina	discipline
districtiones	districtionem
districtione	districtioni
contentionibus	conuentionibus
reuerencia	reuerentia
reuerencie	reuerentia
leprosarum	leprosorum
ministrauit	ministrabit
pontisaram	pontisara
pontificem	pontifice
suprascriptam	suprascriptum
suprascripto	suprascripta
suprascripti	suprascriptis
suprascripte	suprascripta
suprascriptas	suprascriptis
permaneret	permanere
terminatam	terminata
contentione	conuentione
contentiones	conuentione
subscriptarum	subscriptorum
molendinarium	molendinarius
resignaui	resignauit
recipiendam	recipiendum
multiplicata	multiplicato
multiplicatas	multiplicatam
forestario	forestarii
forestariis	forestarius
forestarie	forestarii
forestaria	forestarium
marescalum	marescalus
marescalcus	marescalus
marescaldus	marescalus
preceptoris	precentoris
honestate	honestatem
curtilagii	curtilagio
curtilagia	curtilagio
aquilonali	aquilonari
aquilonaris	aquilonari
aquilonare	aquilonali
seruitutem	seruitute
restitutione	restitutionem
iuramentis	iuramenti
excomunicatus	excomunicatum
excomunicatis	excomunicati
excomunicato	excomunicati
restaurationem	restauratione
restauracione	restauratione
asignatione	asignationem
asignationes	asignationis
permutationes	permutationem
cicestrensi	cicestrensis
cicestriensis	cicestrensis
maiestati	maiestatis
majestatis	maiestatis
dicebantur	dicebatur
adiacentem	adiacente
adiacentes	adiacente
comitatuum	comitatum
beluacensi	beluacensis
beluacenses	beluacensem
prebendarium	prebendarius
substituendi	substituendis
consenciens	consentiens
prepositure	prepositura
preposituram	prepositura
extiterint	extiterit
exstiterit	extiterit
cirografato	cirograpato
cirograpati	cirografato
cirograpata	cirograpato
cirograpate	cirograpato
cristianis	cristianos
cristianus	cristianam
cristiano	cristianos
christianos	cristiano
suesionensi	suesionensis
residente	residentes
presidentes	residentes
autoritas	auctoritas
arciepiscopatu	arciepiscopatus
arciepiscopatum	arciepiscopatus
soluendarum	soluendorum
indulgentia	indulgentiam
indulgenciam	indulgentia
indulgentias	indulgentiis
consenserint	consenserit
utilitatis	utilitati
confratrem	confratrum
confratris	confratrie
malmesburie	malmesburia
malmesburiam	malmesburia
bertrandus	bertranus
propinquiorem	propinquiores
propinquiore	propinquior
propinquioris	propinquiores
contingentes	contingente
contingent	continente
pontiniac	pontiniaci
pontiniaco	pontiniaci
pontigniaci	pontiniaci
cassatarum	cassatorum
casatorum	cassatorum
estimatione	estimationem
extimationem	estimatione
reditionem	reditione
prudentium	prudentum
reparatione	reparationem
presentationi	presentationis
octodecimo	octodecim
inspirate	inspirante
archiepiscopi	arciepiscopi
archiepiscopis	arciepiscopi
consentientes	consentiente
consenciente	consentientes
elemosinis	elemosinas
helemosinis	elemosinas
eleemosinis	elemosinas
quadrantes	quadrantem
dilectione	dilectionem
cicestrens	cicestren
karitatiue	caritatiue
caritatiua	caritatiue
anuntiationem	anunciationem
anunciatione	anuntiationem
feofamenti	feofamento
fefamento	feofamento
feofamenta	feofamento
margaritam	margarita
salinensi	salinensis
soluerimus	uoluerimus
renuntians	renuncians
renunciant	renuncians
cristoforo	cristofori
condicionis	conditionis
inquietari	inquietare
inquietaret	inquietare
intentionem	intentione
inuentione	intentionem
intencione	intentione
inpedimentum	impedimentum
infirmitatem	infirmitate
constabularium	constabularius
constabulariis	constabularius
conestabularius	constabularius
resignatione	resignationem
autisiodoro	autisiodori
autisiodor	autisiodori
altisiodori	autisiodoro
tenerentur	teneretur
confectione	confectionem
constructam	constructum
constructo	constructa
constructe	constructa
constructas	constructis
gislebertus	gilebertus
conceserat	conceserit
concesserit	conceserat
conceserim	conceserat
warantizabit	warantizauit
warentizauit	warantizauit
possessiones	possessionem
possessione	possessionem
possessionum	possessionem
temeritatem	temeritate
constituerant	constituerat
antedictam	antedicta
perturbari	perturbare
clausturam	clausuram
satisfaceret	satisfacere
confitemur	confitetur
confitentur	confitetur
quotienscumque	quocienscumque
quocienscunque	quotienscumque
subscriptionem	subscriptione
saresberiensis	saresberiensi
saresbiriensi	saresberiensis
saresburiensi	saresberiensi
salesberiensi	saresberiensis
sarisberiensi	saresbiriensi
infangenetef	infangeneteof
infangenteof	infangenetef
infangenetheof	infangenetef
batoniensis	batoniensi
indempnitate	indempnitati
indemnitati	indempnitate
parociale	parocialem
parociales	parocialem
trenorciensi	trenorciensis
trenorcienses	trenorciensem
dilectioni	dilectionis
premisimus	remisimus
necessarium	necesarium
inueniemus	inuenimus
senescalum	senescalus
senescalis	senescali
senescalcus	senescalus
cauilationi	cauilatione
athelredus	ethelredus
ethelredes	ethelredus
frequentes	frequenter
frequentem	frequenter
parentibus	patentibus
petentibus	patentibus
potentibus	patentibus
quorumcunque	quorumcumque
quarumcumque	quorumcunque
donauerant	donauerat
seruaturam	seruaturum
seruiturum	seruaturum
liberatione	liberationem
liberationes	liberationis
considerato	considerata
subdecanum	subdecanus
excomunicatam	excomunicatum
excommunicatum	excomunicatus
athelstanus	ethelstanus
ethelstanes	ethelstanus
prouidentiam	prouidentia
prouidencia	prouidentia
providentia	prouidentia
prouidentie	prouidentia
eadweardus	eadwardus
inconuulsam	inconuulsum
excomunicationem	excomunicatione
reuerendum	reuerendus
necessitatibus	necesitatibus
forestarium	forestarius
forestarios	forestarius
beuerlacensi	beuerlacensis
conuertendas	conuertendam
conuertenda	conuertendam
conuertendum	conuertendam
brittannie	britannie
britanniae	brittannie
britannice	britannie
subiaceant	subiaceat
consuetudinis	consuetudines
consuetudini	consuetudines
cimiteriis	cimiterii
cirencestre	cirencestrie
cirencest	cirencestr
confirmante	confirmantes
comorantis	comoranti
sanctimonialis	sanctimoniales
sentencialiter	sententialiter
subdiacono	subdiaconi
subdiaconis	subdiaconus
edificandam	edificandum
liberalitatem	liberalitate
taxatione	taxationem
taxationes	taxationis
principalem	principales
commendare	comendare
anathemate	anatemate
ioscelinus	iocelinus
prouisionem	prouisione
prouisioni	prouisione
promisione	prouisionem
permutatione	permutationem
tricentesimo	trecentesimo
trescentesimo	trecentesimo
contingens	continens
respondeat	respondeant
respondent	respondeat
personatu	personatus
personatui	personatus
aprobante	aprobantes
nouiomensi	nouiomensis
auctentico	autentico
prescriptos	prescriptis
prescriptio	prescriptis
persistencium	persistentium
incipient	incipiente
incipientes	incipiente
humolariensi	humolariensis
propositum	prepositum
deseruiret	deseruient
sepedictam	sepedicta
comunitati	comunitatis
aremburgis	eremburgis
eramburgis	aremburgis
eremburgi	eremburgis
heremburgis	eremburgis
peremptorio	peremptorie
labentibus	habentibus
instinctus	instinctu
instinctum	instinctu
infrascriptas	infrascriptis
infrascripti	infrascriptas
infrascriptos	infrascriptis
respondebat	respondebit
residentium	residentiam
residenciam	residentiam
spectantem	spectantes
spectante	spectantes
spectantis	spectantia
sectantes	spectantes
hospitalitate	hospitalitatem
presentatum	presentatus
presentamus	presentatus
presentatos	presentatus
presentatis	presentatio
munificentia	munificentie
munificenciam	munificentia
munificentiae	munificentie
superioris	superiori
proueniret	prouenient
uniuersitate	uniuersitatem
pietanciam	pitanciam
pontiniacensis	pontiniacensi
specialis	specialius
specialibus	specialius
electioni	electionis
celebratur	celebratam
celebrentur	celebratur
refectorii	refectorio
comutatione	comutationem
comutationes	comutationis
computationem	comutatione
responderunt	respondebunt
sustentare	sustentari
excelencie	excelencia
amicabiles	amicabilem
cesauerit	cesauerint
impedientes	impedientem
inpedientem	impedientes
impediente	impedientem
restitueret	restituere
satisfecerint	satisfecerit
examinatus	examinatis
examinatos	examinatis
intentionis	inuentionis
baldwinus	baldewinus
baldewinum	baldewinus
baiocensis	baiocensi
asignauerat	asignauerit
asignauerint	asignauerunt
coroborari	coroboraui
coroborare	coroboraui
serenisimi	serenisimo
altercatione	alternatione
altercationis	altercationes
competentius	competentibus
decimationes	decimatione
decimationem	decimatione
christianitatis	cristianitatis
sacerdote	sacerdotes
arcidiaconatu	arcidiaconatus
arcidiaconatum	arcidiaconatus
arcidiaconatui	arcidiaconatus
faucunberg	faucunberge
fauconberge	faucunberg
faucumberge	faucunberg
constrictum	constructum
disponentes	disponente
gewitnysse	gewitnesse
gewytnesse	gewitnesse
aethelmund	athelmund
ethelmundo	ethelmund
episcopales	episcopalem
pentecost	pentecoste
cantuariam	cantariam
suficientia	suficienti
suficient	suficienti
raginaudus	rainaudus
quietumclamaui	quietumclamauit
primogenito	primogeniti
primogenita	primogenitum
sanctitati	sanctitatis
cepiscopos	episcopos
apostolicis	apostolici
apostolicus	apostolici
apostolicos	apostolici
subdiaconum	subdiaconus
augmentatione	augmentationem
conuenerant	conuenerat
conuenerint	conuenerunt
societate	societatem
primogenitum	primogenitus
afectionem	afectione
affectione	afectione
campipartem	campiparte
castelani	castelania
castelaria	castelania
castelanie	castelania
castelaniam	castelaria
castelanis	castelanus
castelana	castelania
venerabili	uenerabili
venerabile	uenerabili
elemosinarium	elemosinaria
eleemosinarum	elemosinarum
ethelgeard	ethelweard
ethelwerd	ethelweard
ethelward	ethelweard
ethelheard	ethelweard
athelweard	ethelweard
aethelweard	ethelgeard
confesionem	concesionem
confesiones	concesionem
peronensi	peronensis
peronenses	peronensem
leicestre	leicestrie
leecestrie	leicestrie
leicestria	leicestrie
leircestrie	leicestrie
circumgyrata	circumgirata
byrhferth	byrhtferth
jacentibus	iacentibus
renuntiauit	renunciauit
renunciaui	renunciauit
prenotati	prenotatis
prenotatos	prenotato
prenotatas	prenotata
prenotatus	prenotatum
irequisito	requisito
compromiso	compromisi
compromisio	compromisi
compromisit	compromisi
carnotense	carnotensem
posidendos	posidendas
posidendo	posidendas
posidendis	posidendi
guarantiam	garantiam
reuertantur	reuertentur
uicecomitem	uicecomite
uicecomites	uicecomite
uicecomitum	uicecomite
asumptione	asumptionem
perceperint	perceperunt
perceperant	perceperunt
contingebant	contingebat
continebat	contingebat
custodiret	custodient
uexationem	uexatione
excomunicari	excomunicati
excomunicatio	excomunicati
discretionis	discretioni
discretione	discretionem
torneberg	torneberge
tornberge	torenberge
molismensis	molismensi
arpenorum	arpentorum
relaxationem	relaxatione
relaxationes	relaxationis
inferioris	inferiori
districtus	districtu
districtis	districti
transfere	transferre
incolumitatem	incolumitate
elemosinarie	elemosinario
elemosinarii	elemosinario
elemosinaria	elemosinario
eleemosinario	elemosinario
procurauit	procuraui
diuionenses	diuionensis
diuionensi	diuionensis
conspectui	conspectu
conspectum	conspectu
munificencie	munificentia
legentibus	degentibus
debentibus	degentibus
ascensione	ascensionem
inquietudinem	inquietudine
constituerit	constituerat
posederant	posederat
posederint	posederit
recipiendas	recipiendos
recipiendis	recipiendi
recipiendo	recipiendi
presentando	presentandus
presentandis	presentandus
presentanda	presentandi
sucentorem	sucentore
submiserint	submiserunt
stipulatione	astipulatione
congregationi	congregationis
congregationem	congregatione
haberentur	haberetur
uiolentia	uiolentiam
uiolenciam	uiolentiam
uiolentias	uiolentiam
sucesionem	sucesione
sucesiones	sucesionis
transacto	transactio
transactis	transactio
transacti	transactio
propinquiori	propinquior
procurarunt	procurabunt
ordinarii	ordinariis
ordinarius	ordinarium
reclamabant	reclamabunt
perturbationem	perturbatione
instituti	institutio
instituto	institutio
precipiente	precipientes
recipientes	precipientes
obliuionis	obliuioni
residentem	residentes
pactionibus	actionibus
oxeneforde	oxenefordie
aliquandiu	aliquamdiu
quingentis	quingentas
quingentos	quingentas
quingenta	quingentas
conquestu	conquestus
conquestum	conquestus
cohertionis	cohertioni
cohertione	cohertionem
recognoscat	recognoscit
recognosci	recognosco
perfruantur	perfruatur
antecesore	antecesor
deuenerit	deuenerint
euenerint	deuenerint
deuenerunt	deuenerint
executione	executionem
contestatam	contestata
ioisbertus	iosbertus
dorobernie	dorobernia
dorovernia	dorobernia
refectione	refectionem
refectiones	refectionis
monitionem	monitione
amonitione	monitionem
pictauiensis	pictauensis
pictauensi	pictauiensis
suscepiset	suscepise
recipiatis	precipiatis
forifactum	forefactum
carpentarium	carpentarius
aniuersariis	aniuersarii
quietuclamase	quietumclamase
mauziacensi	mauziacensis
perceptionem	perceptione
participationem	participatione
resipuerint	resipuerit
religiosam	religiosa
prenotatam	prenotata
obseruandum	obseruandam
comparauit	comparuit
condempnatus	condempnamus
condemnamus	condempnamus
profesione	profesionem
procesionem	profesione
profesiones	profesionis
posideret	posiderent
tranquilitate	tranquilitatem
tranquilitatis	tranquilitati
mclxxxuiii	mclxxuiii
mcxxxuiiii	mcxxxiiii
adquietare	acquietare
aquietare	acquietare
acquitare	acquietare
acquietaret	acquietare
propositis	prepositis
propositi	prepositis
altaragium	alteragium
prefiximus	prediximus
karaxantur	caraxantur
carraxantur	caraxantur
molestaret	molestare
celebranda	celebrando
celebrandi	celebrando
celebrande	celebrando
ministrari	ministrare
submonitionem	sumonitionem
sumonitione	submonitionem
sumonitiones	sumonitionem
persoluatur	persoluantur
persoluentur	persoluatur
persoluendo	persoluenda
persoluendam	persoluendum
persoluende	persoluenda
uisitationem	uisitatione
insolentiam	insolenciam
multitudinem	multitudine
multitudini	multitudine
athelstani	athelstan
athelstano	athelstan
calumniam	calumpniam
restitutioni	restitutionis
permutatis	permutatio
gualeranus	galeranus
intererant	intererunt
moisiacensi	moisiacensis
percipiebant	percipiebat
percipiebam	percipiebat
solemnitate	solempnitate
solempnitatem	solempnitate
solempnitates	solempnitate
inquietationem	inquietatione
transmisimus	transmitimus
obseruaturam	obseruaturum
calumpniabantur	calumpniabatur
calumniabatur	calumpniabatur
celebrandam	celebrandum
apelationis	apelationi
ambianensi	ambianensis
simporiano	simporiani
sanctiioanis	sanctiiohanis
parociatus	parociatu
eleemosina	elemosina
eleemosinas	elemosina
walsingeham	walsingham
ireuerenter	reuerenter
dispensator	dispensatore
dispensatores	dispensatoris
consueuerat	consueuerant
consueuerit	consueuerant
incremento	incrementi
incrementa	incrementi
incrementis	incrementi
transactioni	transactionis
transuersu	transuersum
serenitatis	serenitati
castelanum	castelanus
nominationem	dominatione
cantwariorum	cantuariorum
dedicationi	dedicatione
frendlice	frendliche
premonstracensis	premonstratensis
premonstratensi	premonstratensis
coniuncti	coniunctim
possidendum	posidendum
fundationem	fundatione
relationem	relatione
maledictione	maledictionem
maledictiones	maledictionis
necessitas	necesitas
ebroicensi	ebroicensis
comunitate	comunitatem
preceperit	receperit
continebantur	continentur
atemptaret	atemptare
iniunximus	iniungimus
meliorationem	melioratione
aualonensi	aualonensis
ibernagii	hibernagii
hibernagio	hiuernagio
famulancium	famulantium
congregatis	congregatio
congregati	congregatio
congregato	congregatio
congregacio	congregatio
recedentibus	precedentibus
prouinciam	prouincia
inueniantur	inueniatur
inuenietur	inueniantur
inuenitur	inueniatur
gratificamus	ratificamus
contumelia	contumeliam
defendendam	defendendum
dedicationem	dedicatione
norhamton	norhampton
nortampton	norhampton
hermengardis	ermengardis
emengardis	emeniardis
absolutionem	absolutione
prenominatarum	prenominatorum
contulerit	contulerat
undecunque	undecumque
etheluuold	atheluuold
lincolniam	lincolnia
patrimonio	matrimonio
matrimonii	patrimonio
matrimonia	matrimonio
compacientes	compatientes
scriptores	scriptore
carpentarii	carpentario
suspentionis	suspensionis
transgresiones	transgresione
transgresionem	transgresione
herebertum	herbertum
parociatibus	parocialibus
pontiniacenses	pontiniacensis
pontiniacensem	pontiniacensis
laudabili	laudabilis
laudabiles	laudabilem
statuerint	statuerit
statuerent	statuerunt
conseruentur	conseruetur
egritudinem	egritudine
potueritis	poteritis
aquarumue	aquarumque
ejusdemque	eiusdemque
sustineant	sustineat
aquilonalem	aquilonali
inuenerit	inuenerint
inuenerunt	inuenerint
incurerit	incurerint
incurerunt	incurerint
incurerent	incureret
deseruient	deseruiet
auctenticum	autenticum
procuraret	procurarunt
seruituros	seruaturos
seruaturas	seruaturos
pertinentiarum	pertinenciarum
catedralis	catedrali
cancelatam	cancelatas
cancelatis	cancelatas
comisarius	comisariis
comisarii	comisariis
comisarios	comisario
pronuntiamus	pronunciamus
constantinus	constantius
constantiis	constantius
constantium	constantinus
aliquantulam	aliquantulum
consimilis	consimili
consimilia	consimili
serviendum	seruiendum
ordinandis	ordinandi
imperatori	imperator
dispositioni	dispositione
dispositionis	dispositione
succedentibus	sucedentibus
sanctisimo	sanctisimi
sanctisime	sanctisimi
sanctissimi	sanctisime
sanctisima	sanctisimi
sanctisimis	sanctisimi
remanentes	remanente
restituent	restituet
uestimento	uestimenta
paupertate	paupertatem
auctenticis	auctentico
autentici	auctentico
prestiterint	prestiterit
uenditarum	uenditorum
ingredientur	ingrediantur
ingrediatur	ingrediantur
bituricensi	bituricensis
sanctisque	sanctique
confecimus	conferimus
conferemus	conferimus
conferamus	conferimus
custodiant	custodiat
remanerent	remaneret
arcebisceop	arcebiscop
ercebiscop	arcebiscop
archebiscop	arcebiscop
arcebiscope	arcebiscop
constitutione	constitutionem
constitutiones	constitutionis
alterutras	alterutra
celebratam	celebrata
sullimatus	sublimatus
deseruiant	deseruient
buckingham	bukingham
bukingeham	buringeham
conuersatione	conuersationem
reuerendisimo	reuerentisimo
reuerentisimi	reuerentisimo
andegauenses	andegauensis
andegauensi	andegauensis
probationem	probatione
prolatione	probationem
probationes	probationis
aprobatione	probationem
prouiderit	prouidebit
intendamus	intendimus
bilsingtone	bilsintone
altisiodorum	autisiodorum
comportant	comportat
presidentibus	residentibus
antedictum	antedictam
querimonia	querimoniam
querimonias	querimoniis
perseuerauerint	perseuerauerit
archiepiscoporum	arciepiscoporum
archangeli	arcangeli
constituiset	constituise
presenciarum	presentiarum
exprimendas	exprimenda
semplingham	sempingham
sempringham	sempingham
decimationis	decimationes
transactione	transactionem
inuestiui	inuestiuit
inuestiunt	inuestiuit
persoluimus	persoluemus
concedendam	concedendum
concedenda	concedendo
concedendis	concedentes
deulacrese	deulacres
linialiter	linealiter
satisfaciant	satisfaciat
satisfaciet	satisfaciant
uiderentur	uideretur
inuiolabilem	inuiolabile
inuiolabili	inuiolabilis
adquisitis	acquisitis
acquisitas	acquisita
acquisiuit	adquisiuit
adquisiui	adquisiuit
adquisivit	adquisivi
uenationem	uenatione
uenationes	uenationis
audientiam	audientia
terminanda	terminandam
terminandum	terminandam
impeditione	impetitione
intrauerit	intrauerint
intrauerunt	intrauerint
renuntiando	renunciando
uendemiarum	uindemiarum
flauigniacensi	flauigniacensis
flauiniacensis	flauigniacensis
ualentibus	uolentibus
colentibus	uolentibus
nolentibus	uolentibus
monasteriolum	monasteriorum
requiescat	requiescit
uoluntaria	uoluntarie
voluntarie	uoluntarie
uoluntario	uoluntarie
perueniant	perueniat
emerserint	emerserit
precedenti	precedente
recedente	recedentes
procedente	procedentes
precedentes	precedenti
leodegario	leodegarii
sollicitudo	solicitudo
cantebrigia	cantebrigiam
renuntiauerunt	renunciauerunt
asportatam	asportata
quarterios	quarterio
quarterii	quarteriis
prohibitione	prohibitioni
reclamabat	reclamabit
consciencia	conscientia
conscientiam	conscientia
conscientie	consciencia
monimentum	munimentum
constitutioni	constitutionis
religioni	religionis
inuestitura	inuestituram
uincentium	uincentius
instantius	instantis
retinuerint	retinuerit
detinuerunt	retinuerint
excelenciam	excelencia
construxi	construxit
spiritualia	spirituali
spiritualis	spirituali
spiritali	spiritualis
qualicunque	qualicumque
qualiscumque	qualicumque
qualecumque	qualemcumque
archipraesul	archipresul
custodiendam	custodienda
dunelmense	dunelmensi
forifacto	forisfacto
forisfacti	forisfactis
forisfacta	forifacta
aisiamento	aisiamenta
rediderit	rediderint
crediderit	rediderint
claustrali	claustralis
claustrales	claustralis
contingencia	contingentia
continentia	continente
contingentis	contingentia
presentato	presentatio
presentati	presentato
capelania	capelaniam
almauricus	amauricus
huntindonie	huntendonie
sustinuerit	sustinuerint
sustinuerunt	sustinuerint
parisiensem	parisienses
parisiense	parisiensi
niuernense	niuernensem
perenniter	perhenniter
perheniter	perenniter
satagerint	satagerit
concedendi	concedendo
studuerint	studuerit
consisteret	consistere
celebrationem	celebratione
celebrationi	celebrationis
procederet	procederent
consistant	consistat
sacerdotalis	sacerdotali
susceptione	susceptionem
parocianum	parociarum
patrimonium	matrimonium
suprascriptos	suprascriptis
suprascriptus	suprascriptum
helemosinarius	elemosinarius
uisitauerit	uisitauerint
oxenefordia	oxenefordiam
oxenfordie	oxenefordie
conuentualis	conuentuali
conuentuale	conuentualis
districtionis	districtioni
instituendis	instituendus
instituendo	instituendi
ministraturo	ministraturi
ministraturis	ministraturus
matiscensi	matiscensis
munitionem	munitione
munitiones	munitione
econtrario	contrario
multiplicem	multiplices
ministeria	ministerio
ministerii	ministeriis
triumphale	triumphali
recipiens	precipiens
prelatorum	prefatorum
prefatarum	prefatorum
diuisione	diuisionem
diuisiones	divisiones
monimentis	munimentis
constante	constanter
conferantur	conferuntur
conferentur	conferuntur
curtilagiis	curtilagii
maiestatem	maiestate
cognitionem	cognitione
cognitioni	cognitione
cognatione	cognitione
inuentionem	intentionem
presententur	presentetur
spectancia	spectantia
ordinante	ordinantes
dignaretur	dignaremur
diseisiauerunt	diseisiuerunt
wermenhale	wormenhale
acquisierint	acquisierunt
adquisierunt	acquisierint
acquisierant	acquisierat
iouigniaci	iouiniaci
stepanensium	stepaniensium
teritoria	territoria
dignitatum	dignitatem
forisfactura	forisfacturam
forisfacturas	forisfacturam
celebriter	celeriter
construendam	construendum
consensimus	consentimus
consentiemus	consentimus
examinacionis	examinationis
extiterunt	extiterint
extiterant	extiterat
exstiterunt	extiterint
prouidente	prouidentes
adnotatione	anotatione
protestatur	protestatus
admitantur	admitatur
conuertat	conuertant
propinquis	propinquius
propinquus	propinquius
edificatione	edificationem
emolumenti	emolumenta
uetustatem	uetustate
fraternitate	fraternitati
peregrinationem	peregrinatione
sustentationi	sustentationis
cestrensi	cestrensis
intromitant	intromitat
intromitet	intromitant
recuperaui	recuperauit
euidenciam	euidentiam
euidentia	euidentiam
beatissime	beatissimi
comunione	comunionem
communionem	comunione
legrecestria	legrecestrie
cirencestria	cirencestrie
prouidemus	prouidimus
confesionibus	concesionibus
malefactorem	malefactorum
translatione	translationem
instituendum	instituendus
instituendos	instituendus
lugdunense	lugdunensem
forfactum	forefactum
landgemero	landgemera
landgemere	landgemera
landgemeru	landgemera
contradiceret	contradicere
desiderant	desiderat
redemptori	redemptor
confirmant	confirmans
expedicionis	expeditionis
competebant	competebat
rectitudines	rectitudinem
rectitudine	rectitudinem
staunforde	stanforde
flandrensis	flandrensi
flandrens	flandrensi
mercatorem	mercatore
quadragesimam	quadragesima
adiudicate	adiudicata
prohibente	prohibentes
concanonicus	concanonicum
pertinebunt	pertinebant
recipienda	recipiendi
recipiend	recipiendi
diuidantur	diuidentur
procurabimus	procurauimus
calumpniari	calumpniare
calumniare	calumpniari
claromontensi	claromontensis
industriam	industria
preteriti	preteritis
antiquarum	antiquorum
districtio	districto
augmentari	augmentati
imperatore	imperator
fraternitatis	fraternitati
consecratione	consecrationem
exaltatione	exaltationem
postposito	postposita
benignitatem	benignitate
benignitati	benignitatis
permanent	permanente
trescentis	crescentis
lexouiensis	lexouiensi
luxouiensi	lexouiensis
ocidentalem	ocidentale
occidentalem	occidentali
possederat	posederat
remanserint	remanserunt
submonitus	sumonitus
receptionem	receptione
deceptione	receptione
receptioni	receptione
corectione	corectionem
colectionem	corectione
corectiones	corectionis
frotmundus	fromundus
incontinentia	incontinenti
suffragiis	sufragiis
compositorem	compositores
laudunensi	laudunensis
aurelianense	aurelianensi
aurelianensem	aurelianensi
augmentato	augmentati
consistunt	consistant
iniquitates	iniquitatem
perfruendam	perfruendum
clemenciam	clemencia
restituant	restituat
exercitium	exercitum
retinendam	retinendum
florentini	florentino
ricemundia	ricemundie
sumercote	sumercotes
somercotes	sumercotes
asignandam	asignanda
asignandas	asignandis
comparentem	comparentes
comparente	comparentes
incumbencia	incumbentia
quarentenas	quarentena
wincecumbe	wincecumb
frankelain	frankelein
transferendi	transferendo
presencialiter	presentialiter
prosperitatem	prosperitate
ostenderet	ostendere
uerumptamen	uerumtamen
ueruntamen	uerumtamen
posteritati	posteritatis
wlfstanus	wulfstanus
wulfstanes	wulfstanus
wulstanus	wulfstanus
aduenerint	aduenerit
agricultura	agriculturam
gloucestriam	gloucestria
glocestriam	gloucestria
debebatur	debebantur
debeantur	debebantur
debebuntur	debebantur
claudendam	claudendum
decimationum	decimationem
conuersione	conuersionem
conseruanda	conseruandam
conseruandum	conseruandam
conuertatur	conuertantur
conuertentur	conuertatur
inspectionem	inspectione
dunelmens	dunelmensi
contemptu	contemptum
contemptus	contemptum
colationi	colationis
fidedignis	fidedignos
cluniensi	cluniensis
clunienses	cluniensis
tornodorensi	tornodorensis
constitutam	constituta
principatus	principatum
primicherius	primicerius
ordinauerint	ordinauerit
cristiani	cristianis
christiani	cristiano
asertionem	asertione
paupertati	paupertate
paupertatis	paupertate
distribuantur	distribuatur
distribuetur	distribuantur
testificamus	testificatus
testificatur	testificantur
cirografatum	cirograpatum
couentrens	couentrensi
couentren	couentrensi
defendendi	defendendo
defendenda	defendendo
winterburne	winterburn
winterborn	winterburne
obseruatam	obseruatum
renuntiamus	renunciamus
denunciamus	renuntiamus
morgneuale	morgneual
porprisiam	porprisium
figiacensi	figiacensis
nostrisque	nostrique
aliarumque	aliorumque
decreuerint	decreuerunt
decreverit	decreuerit
solueritis	uolueritis
quarumlibet	quorumlibet
patientiam	patientia
instructionem	instructione
testimoniis	testimonii
wigornensi	wigornensis
largifluam	largiflua
beneplacito	beneplacita
requireret	requirere
etheluuine	atheluuine
obedienter	obedientes
consanguineis	consanguineus
consanguineum	consanguineus
edificatam	edificata
susceperint	susceperunt
constantino	constantini
constantii	constantia
obseruanciam	obseruantiam
obseruantia	obseruantiam
obseruantias	obseruanciam
spectabant	spectabat
laudationem	laudatione
laudationi	laudationis
detrimenti	detrimento
existentis	existentes
existentia	existentes
existenti	existentes
licfeldensis	licefeldensis
licefeldensi	licefeldensis
licetfeldensis	licefeldensis
lichefeldensis	licefeldensis
licesfeldensis	licefeldensi
aprobationis	probationis
garantizabit	warantizabit
garentizabit	warantizabit
largitatem	largitate
privilegii	priuilegii
privilegia	priuilegii
eboracense	eboracensem
diligentiam	diligentia
diligenciam	diligentia
subiaceret	subiacere
inefabili	inefabilis
resipiscant	resipiscat
propriarum	propriorum
conferendi	conferenda
conferendam	conferenda
conferendo	conferenda
conferendas	conferendi
prelibati	prelibatis
prelibatos	prelibato
prelibatus	prelibatam
incessanter	incesanter
walingeford	walingford
walingforde	walingford
pretaxatis	pretaxati
eclesiasticarum	eclesiasticorum
ecclesiasticorum	eclesiasticarum
mutatione	mutationem
contractus	contractum
contractu	contractum
contractui	contractum
beatriciam	beatricia
forinseci	forinsecis
suplicaui	suplicauit
recognoscant	recognoscunt
pertinendis	pertinentis
securitati	securitate
securitatis	securitate
quietaclamantia	quietaclamancia
renuntiationem	renunciationem
denunciationem	renunciationem
renunciatione	renuntiationem
negligenter	negligentes
proportant	proportat
arbitratorem	arbitratores
medeshamsted	medeshamstede
piscatione	piscationem
piscationes	piscationis
adstipulatione	astipulatione
monarchia	monarchiam
monarciam	monarchiam
latrocinium	patrocinium
trescentas	trecentas
trinitatem	trinitate
laudabile	laudabilem
atheluuerd	atheluueard
etheluueard	atheluueard
carnifices	carnificis
exhibitione	exhibitionem
inocentius	inocentium
inocentiam	inocentium
emendentur	emendetur
imunitate	imunitatem
imunitates	imunitatem
impunitatem	imunitatem
carectatam	carectatas
certitudine	certitudinem
sustinendo	sustinenda
sustinendam	sustinendum
excomunicamus	excomunicatus
cementarii	cementario
apropriationem	apropriatione
adimplendo	adimplenda
distribuentur	distribuantur
perstiterint	perstiterit
casamenti	casamentis
restauraui	restaurati
guilermete	guilermeta
disciplinam	disciplina
conscripti	conscripta
conscripsit	conscripsi
crescentes	crescentis
desiderii	desideriis
delinquere	relinquere
proferatur	profertur
concedatur	conceditur
reuocentur	reuocetur
consanguinei	consanguineo
distributionem	distributione
distributiones	distributione
exequendam	exequendum
succedentium	sucedentium
anguillarum	anguilarum
cantuaria	cantuariam
exequantur	exequatur
uenationibus	uexationibus
persoluetur	persoluatur
uendicabunt	uendicabant
uendicabat	uendicabant
amoueantur	amoueatur
instituatur	instituetur
instituentur	instituatur
executioni	executione
executionis	executione
disaisiuit	diseisiuit
cognoscentes	cognoscente
necessitatis	necesitatis
compareat	compareant
posidebimus	posidebamus
posideamus	posidemus
pontisariensis	pontisarensis
beatitudine	beatitudinem
servitutem	servitutum
singulari	singularis
retributione	retributionem
restituantur	restituatur
restituetur	restituantur
uniuscujusque	uniuscuiusque
ministrantem	ministrantes
ministrantis	ministrantes
profuturam	profutura
inhabitandam	inhabitandum
uendiderat	uendiderit
pretaxatam	pretaxata
pretaxatas	pretaxata
excessibus	excesibus
deliberari	deliberare
deliberate	deliberato
deliberase	deliberare
palefredum	palefridum
pietantiam	pitantiam
diuidetur	diuidentur
hospitalariis	hospitalarii
asignarunt	asignabunt
recipiamus	recipiemus
adquietatione	acquietatione
aquietatione	acquietatione
acquitatione	acquietatione
percipiendarum	percipiendorum
scaldeston	saldeston
quantumcunque	quantumcumque
compelatur	compelantur
compelentur	compelatur
haimericus	aimericus
admodiatione	admodiationem
ecclesiastice	eclesiastice
ecclesiastici	eclesiastice
etheldredi	ethelredi
sapientium	sapientum
coedificacione	coedificatione
commendamus	comendamus
adquisitas	adquisita
distribuendos	distribuendas
distribuendam	distribuendum
distribuendis	distribuendas
promotione	promotionem
lincolniense	lincolniensem
clausturis	claustris
radingensi	radingensis
radingenses	radingensis
superiorem	supriorem
subpriorem	subpriore
uocationis	uacationis
prouideant	prouideat
auctentica	auctentico
inueniendam	inueniendum
perceperit	perceperint
preceptori	preceptor
scireburne	scireburn
celebrantes	celebrantem
celebrante	celebranti
constructio	constructis
indulgenciis	indulgentiis
glouuernia	glouernia
adquisiuimus	acquisiuimus
huntindon	huntingdon
instancia	instanciam
scirburnensis	scireburnensis
continent	continente
continenti	continente
contineant	continebat
continuent	continente
mancipatis	mancipati
mancipatos	mancipatus
utrarumque	utrorumque
subsequenter	subsequentes
subsequente	subsequenti
subsequentem	subsequentes
subsequentis	subsequenti
conscriptam	conscripta
cyneberhti	cyneberht
inposuerunt	imposuerunt
altithrono	altithroni
altitroni	altithroni
superstites	superstite
superstiti	superstite
superstitem	superstite
exactionis	exactiones
exactioni	exactiones
iherosolimam	ierosolimam
hierosolimam	ierosolimam
saresbiriensis	saresberiensis
saresburiensis	saresberiensis
salesbiriensis	saresberiensis
conuenientes	conuenienter
conuenientem	conuenienter
quietanciam	quietantiam
quietantias	quietantiam
institutioni	institutionis
obtinendam	obtinenda
obtinendas	obtinenda
berengario	berengarii
berengaria	berengarii
berengerii	berengarii
negligentia	negligentiam
negligenciam	negligentia
candelabrum	candelarum
difinitione	difinitionem
apropriata	apropriatam
infirmare	infirmarie
honestati	honestatis
mclxxxuii	mclxxxuiii
sucentori	sucentoris
suprioris	subprioris
subpriori	subprioris
personalem	personales
personalis	personali
personale	personales
persoluetis	persolutis
persoluatis	persolutis
persoluti	persolutis
matisconense	matisconensem
postulatione	postulationem
substantiam	substantia
lundoniensi	lundoniensis
infregerint	infregerit
admonitionem	monitionem
diffinitionem	difinitionem
beniuolentia	beniuolentiam
benivolentiam	beniuolentiam
beneuolentiam	beniuolentiam
beniuolenciam	beniuolentia
recepturos	recepturus
recepturum	recepturus
prerogatiuam	prerogatiua
prerogativa	prerogatiua
multotiens	multociens
persoluerunt	persoluerint
persoluerit	persoluerint
persoluerent	persoluerint
determinatur	determinatum
determinatam	determinata
monetariis	monetarius
uicecomitatus	uicecomitatum
uicecomitatu	uicecomitatum
goscelinus	ioscelinus
gocelinus	ioscelinus
roscelinus	ioscelinus
procesione	profesione
procesiones	profesione
edificaui	edificauit
construenda	construendam
construendi	construendam
construendas	construendi
construendo	construendam
inpresionibus	impresionibus
piscatores	piscatoris
restituemus	restituimus
restituamus	restituimus
transcripta	transcripto
satisfacient	satisfaciant
satisfaciens	satisfaciant
acquirendis	adquirendis
blakeburne	blakeburn
blakeburna	blakeburn
ministraturum	ministraturus
ministraturos	ministraturus
merleberg	merleberge
castelacr	castelacra
prouidendo	prouidendi
prouidenda	prouidendi
suplicatione	suplicationi
puplicationem	publicationem
autisiodorense	autisiodorensem
siluanecti	siluanectis
stampensi	stampensis
inquireret	inquirere
presumerent	presumeret
presumere	presumeret
huuicciorum	huicciorum
hwicciorum	huicciorum
gubernaculo	gubernacula
suscipiant	suscipiat
libentisime	libentissime
anotantur	annotantur
adnotantur	annotantur
plenitudinem	plenitudine
beorhtnothe	beorhtnoth
remuneratione	remunerationem
sufficeret	suficeret
suficerent	suficeret
sucedente	sucedentes
excoluerit	excoluerint
excoluerunt	excoluerint
acquisiui	acquisiuit
deuotisimi	deuotisime
deuotissime	deuotisime
rederetur	rederentur
denariatis	denariatas
denariatos	denariatas
coroborauit	coroboraui
indulgentie	indulgentia
indulgencie	indulgentia
indulgente	indulgentes
custodient	custodiant
teodoricus	teodericus
diocesanus	diocesanum
prestitise	prestitis
destructione	destructionem
karliolensi	karleolensi
karleolensis	karleolensi
asignentur	asignetur
habueramus	habuerimus
cirografati	cirografato
cirografate	cirografato
receptionis	deceptionis
deceptioni	deceptionis
catalaunensi	catalaunensis
quotienscunque	quotienscumque
quotiescunque	quotienscumque
antecessores	antecesores
ethilbaldus	ethelbaldus
deneberhto	deneberht
consignatas	consignata
consignatam	consignatum
consignato	consignata
bedefordie	bedeforde
fundatores	fundatoris
aethelwulf	ethelwulf
servantibus	seruantibus
supplementum	suplementum
ilustrisimo	ilustrisimi
asignandos	asignando
asignandi	asignandis
dispensatio	dispensario
dispensari	dispensare
wimundeham	wimundham
conuenienti	conuenientia
conuenientiam	conuenientia
constancia	constantia
constantie	constantia
constancii	constancie
contradicentes	contradicente
solemnitatibus	solempnitatibus
reformatione	reformationem
mercatores	mercatore
posidente	posidentes
inuadiaui	inuadiauit
inuadiabit	inuadiauit
resignaset	resignase
stalingburgh	stalingburg
adquisierint	acquisierint
adquisierant	acquisierint
adquisierit	acquisierint
componendo	componendi
componenda	componendi
percipimus	percipiemus
percipiamus	percipiemus
kersintona	kersinton
pronuntiauimus	pronunciauimus
inquisitioni	inquisitione
inquisitionis	inquisitione
procesimus	procesibus
proceribus	procesibus
iuridictione	iurisdictione
leodegarium	leodegarius
deficeret	deficerent
presoragii	presoragio
herepathes	herpathes
ordinentur	ordinetur
contemplationi	contemplationis
cognominatus	cognominatur
elfthrythe	elfthryth
prosequente	prosequentes
possidemus	posidemus
salesberie	saresberie
saresburie	saresberie
sarisberie	saresberie
saresberia	saresberie
saresbirie	saresberie
mclxxxiiii	mclxxxuiii
aparuerint	aparuerit
reliquimus	relinquimus
presentauerint	presentauerunt
ierosolimitan	ierosolimitani
ierosolomitani	ierosolimitani
conseruatione	conseruationem
alienationes	alienationis
alienatione	alienationem
concesisent	concesiset
compromisionem	compromisione
ireuocabilis	ireuocabili
scriptoris	scripturis
voluntatem	voluntate
custodierint	custodierit
archiepiscopum	archiepiscopus
presumptionem	presumptione
roborentur	roboretur
terminetur	terminatur
terminatum	terminatur
terminantur	terminetur
consiliarios	consiliariis
consiliarii	consiliariis
consecratam	consecrata
consecrate	consecrata
consecrati	consecratio
consecrato	consecratio
temporale	temporalem
consequantur	consequatur
impediatur	impediantur
obediencia	obedientia
prudentiam	prudentia
subnotati	subnotatis
cognoscant	cognoscat
profuturas	profutura
prouenient	proueniens
proueniant	proueniat
adiacentia	adiacenti
adiacentis	adiacentiis
requisiui	requisiuit
prelibatam	prelibata
mercatoris	mercatores
mercatori	mercatores
pretaxatos	pretaxato
redierint	rediderint
dilectisimis	dilectisimi
dilectisimo	dilectissimo
dilectisime	dilectisimi
bridlington	bridelington
presentandus	presentandum
celebraturus	celebraturos
comisarium	comisarum
clerkenwel	clerkenwele
confirmauerat	confirmauerit
proponeret	proponere
wicingeham	wicingham
posideatis	posidetis
uacationem	uacatione
disensiones	disensionis
concanonici	concanonicus
concanonicos	concanonicus
celebrandis	celebrandi
celebrantis	celebrandi
celebrandas	celebrandi
districtum	districtu
branciduni	branceduni
branceduno	branciduni
diuionensem	diuionenses
emolumento	emolumenta
ethelflede	ethelfled
abstulerit	abstulerat
humilitatem	humilitate
promiserit	promiserat
wlfhelmus	wulfhelmus
mansiunculas	mansiunculis
sortiantur	sortiatur
exequendi	exequendis
uenerationem	ueneratione
generatione	uenerationem
facultatum	facultatem
notificari	notificare
optinuimus	obtinuimus
beatissimi	beatisimi
forisfecerint	forisfecerit
forifecerit	forisfecerit
albemarle	albemarlie
scriuenham	scriueham
gualterus	gualterius
quietantiis	quietanciis
quietancias	quietanciis
consulente	consulentes
ioscelinum	iocelinum
templarii	templariis
familiarius	familiarium
compareret	comparere
iuridictio	iurisdictio
examinatione	examinationem
disponendo	disponendi
prouiderunt	prouiderent
responsuros	responsurus
bermundeseiam	beremundeseiam
atrebatensi	atrebatensis
extendentes	extendentem
recipietur	recipiatur
recipiantur	recipietur
recipitur	precipitur
prosequenda	prosequendo
prosequendi	prosequendo
conueniat	conueniant
conueniunt	conueniant
conuenient	conuenisent
deliberat	deliberato
deliberata	deliberato
coronatorem	coronatore
coronatores	coronatore
aldefonsus	adefonsus
aniciensi	aniciensis
curtiniaci	curtiniaco
augustinum	augustinus
communione	comunione
sanctitate	sanctitatem
confirmabit	confirmauit
fragilitate	fragilitatem
adipiscendam	adipiscenda
reconciliationes	reconciliationis
defensores	defensorem
hereditariam	hereditarium
hereditagium	heremitagium
optulerunt	obtulerunt
destitutam	destitutum
restituenda	restituendo
constantiam	constantia
constanti	constantia
constantio	constantia
partitionem	partitione
restituendam	restituendum
clausturas	clausturam
ingeranus	ingelranus
engelranus	ingelranus
ingelramus	ingeramus
catholicis	catolicis
coligendum	corigendum
aduentibus	anuentibus
coroboratam	coroborata
corroboratum	coroboratum
prestandis	prestandi
faueresham	fauersham
custodiendo	custodienda
custodiendas	custodiendis
custodiendi	custodiendis
protulerint	protulerit
prouisionis	prouisioni
promisionis	prouisioni
sepeliatur	sepeliantur
sepelientur	sepeliantur
restituti	restitutio
cerdestoke	cerdestok
habundant	habundanti
habundantia	habundanti
presentet	presentent
presentant	presentante
conueniset	conuenisent
condempnati	condempnari
intulerint	intulerunt
prebendali	prebendalis
concederent	concederet
beneficiatis	beneficiati
comendationem	comendatione
magnificentie	magnificencie
transferent	transfere
siluiniaco	siliniaco
siligniaco	siliniaco
escerento	hescerento
iouigniaco	iouiniaco
corbigniacensi	corbigniacensis
corbiniacensis	corbigniacensis
clugniacensi	cluniacensi
cedentibus	credentibus
ignorantiam	ignorantia
ignorantie	ignorantia
ignorancia	ignorantia
postulante	postulantes
singrapham	singrapha
neglexerit	neglexerint
permansuram	permansurum
edificatum	edificatam
constituent	constituat
determinat	determinant
determinato	determinata
uideantur	uidebantur
dapsilitate	dapsilitatem
middeltone	mideltone
iudiciario	iudiciaria
confirment	confirmet
necesario	necesarios
mutauerint	mutauerit
durauerint	durauerit
inotesceret	inotescere
carleolensi	karleolensi
familiari	familiaris
familiares	familiaris
excusatione	excusationem
purcelorum	porcelorum
gestlinge	gestlinges
gestliges	gestlinges
impetranda	impetrando
inpetrando	impetrando
scardeburg	scardeburgh
scardeburgo	scardeburgh
liberabimus	liberauimus
comitantur	comitatur
comiserint	comiserit
incolumnitatem	incolumitatem
diseisina	diseisinam
bulingtona	bolingtona
asingnati	asingnatis
inuestitus	inuestimus
quotiescumque	quotienscumque
matriculariis	matricularius
trenorciense	trenorciensem
reclamarent	reclamaret
sanctione	sanctiones
sanctionis	sanctiones
sanctionem	sanctiones
predecessores	predecesores
requiretur	requiratur
requiritur	requiratur
suscipient	suscipiet
excerceant	exerceant
famulentur	famulantur
ethelbaldi	ethelbald
aetheluulf	etheluulf
felicitate	felicitatem
metropolitana	metropolitane
metropolitani	metropolitane
metropolitano	metropolitane
custodiantur	custodiatur
custoditur	custodiatur
custodietur	custodiatur
diuturnitatem	diuturnitate
reparandas	reparandis
originalia	originali
originalis	originali
altitudinem	altitudine
aduersarius	aduersarios
aduersario	aduersarios
aduersariis	aduersarios
inuasionem	inuasione
gebrothera	gebrothra
gebrothran	gebrothra
sententiis	sententias
sentenciis	sententias
cognoscendum	cognoscendam
consistorii	consistorio
sufraganeos	sufraganeis
sufraganei	sufraganeis
suffraganeis	sufraganeis
coroborandum	coroborandam
maritagii	maritagiis
prohibitionem	prohibitione
pacificari	pacificare
excolendam	excolendas
excolenda	excolendas
exhibendam	exhibendum
profitetur	profitemur
subicientes	suficientes
subiicientes	suficientes
ierdeburgh	ierdeburg
sustentetur	sustententur
concanonicis	concanonicus
permitente	permitent
nominatione	dominatione
cominatione	dominatione
rebelione	rebelionem
prescriptionem	prescriptione
celebraturi	celebratur
comisiset	comisisent
subtractione	subtractionem
cerleburia	cerleburi
helemosina	elemosina
instructos	instructus
sempiterno	sempiterna
sempiterne	sempiterna
porciunculam	portiunculam
partiunculam	portiunculam
confirmetur	confirmentur
confirmantur	confirmentur
cristianorum	christianorum
confusione	confesione
magisterii	magisterio
inperpetuam	inperpetuum
pecaminum	peccaminum
deseruiunt	deseruient
superiorum	supernorum
liberetur	liberentur
consecratum	consecratus
stabiliuit	stabiliui
demonstrat	demonstrant
profunditatem	profunditate
dcccclxiii	dcccclviii
dcccclxviii	dcccclxiii
dccccxlviii	dccccxlvii
dcccclvii	dccccxlvii
atestantibus	testantibus
eboracisira	eboraciscira
dirationauit	disrationauit
habitatione	habitationem
interfuerit	interfuerint
potissimum	potisimum
inrefragabiliter	irefragabiliter
piscatura	piscaturam
bermundeseia	bermundeseie
proceserat	proceserit
inciderint	inciderit
pretaxatum	pretaxatam
pretaxatus	pretaxatam
dominicarum	dominicorum
inhibitione	inhibitionem
cliuelande	cliueland
anuntiatione	anuntiationem
wigorniens	wigornien
proponebat	proponebant
dispositis	dispositio
excomunicare	excomunicari
mensurata	mensuratas
mensuratam	mensuratas
mensuratis	mensuratas
subscriptum	subscriptam
brinkburne	brinkeburne
sequestris	sequestri
pronunciatione	pronunciationem
predicatione	predicationem
mortuariis	mortuarii
ualterius	gualterius
uualterius	gualterius
adquirenda	acquirenda
acquirendi	acquirenda
quitationi	quitationis
iuridictionis	iurisdictionis
impignoratione	impignorationem
caritatensi	karitatensi
karitatensis	karitatensi
flauigniaci	flauigniaco
dampnationem	dampnatione
glastoniensi	glastoniensis
territoriis	teritoriis
obtinentes	optinentes
aliquociens	aliquotiens
uniuersali	uniuersalis
seruituri	seruituris
commutatio	comutatio
estimantur	estimatur
requirebant	requirebat
requirebam	requirebat
fridericus	fredericus
forifactis	forefactis
substituetur	substituatur
substituantur	substituatur
acipiendo	acipiendos
consuetudinario	consuetudinarii
consuetudinariis	consuetudinario
consuetudinaria	consuetudinarii
resilirent	resiliret
debilitate	debilitatem
defendentibus	dependentibus
comendentur	comendetur
comendatur	comendatum
corroborata	coroborata
operatione	operationes
operationem	operationes
nequiuerit	nequiuerint
sustentandum	sustentandam
promisionem	prouisionem
promisiones	prouisionem
subuentione	subuentionem
subuentiones	subuentionem
quadrigatam	quadrigatas
uestituram	uestitura
uestituras	uestitura
releuatione	releuationem
releuationes	releuationem
respondet	respondeat
declarandam	declarandum
prouidebimus	prouiderimus
prouideremus	prouiderimus
declarando	declarandi
declarandis	declarandi
prebendariis	prebendarii
existencia	existentia
comendauit	comendaui
petrapertusia	petrapertusa
deuestiunt	deuestiuit
interdico	interdicto
coldingham	colingham
promulgari	promulgare
promulgate	promulgata
omnipotente	omnipotenti
omnipotentem	omnipotenti
possessionis	possessiones
promulgat	promulgata
propinqui	propinquis
supranominati	supranominata
celebranti	celebrati
celebratis	celebrati
surexerit	surrexerit
optinendam	obtinendam
optinenda	obtinendam
optinendas	optinendis
interioribus	inferioribus
tempestates	tempestate
deliquerunt	reliquerunt
reliquerint	reliquerunt
calumpniis	calumpnias
calumniis	calumpnias
fundamento	fundamenta
iocunditate	iocunditatem
susceperit	susceperat
sacrosanctam	sacrosanctum
quamplurimi	quamplurima
patrimonii	patrimonio
patrimonia	patrimonio
perficiendam	perficiendas
lundoniensem	londoniensem
adquisierat	acquisierat
acquisierit	acquisierat
tenuitate	tenuitatem
suffragium	sufragium
concordat	concordati
concordato	concordati
concordata	concordati
reuerentie	reuerentia
suesionis	sucesionis
indempnitatem	indempnitate
landauensi	landauensis
warantizandam	warantizandum
garantizabo	warantizabo
ministranti	ministrandi
ministrando	ministrandi
exceptiones	exceptione
exceptionem	exceptione
tesaurariam	tesaurarium
ministrent	ministret
presentata	presentato
presentatam	presentato
claustura	clausturam
mclxxxiii	mclxxxuiii
proponentes	proponente
prosequamur	prosequimur
ethelberti	etelberti
preceptorem	precentorem
preceptorum	precentorem
mesagiorum	mesuagiorum
reformande	reformanda
reformandam	reformandum
confitebantur	confitebatur
complendum	compelendum
permiterent	permiteret
permitere	permiteret
purpresturas	purprestura
distringat	distringant
exigenciam	exigentiam
procurauerint	procurauerit
fideiusorum	fideiusorem
marciliaco	martiliaco
martiniaco	martiliaco
manumortuam	manumortua
manusmortua	manusmortue
seruauerit	seruauerint
distribui	distribuit
distribuet	distribuit
distribuat	distribuit
antistitis	antistiti
recordatione	recordationem
peruenerunt	peruenerint
condonaui	condonauit
condonavit	condonauit
periculose	periculosa
deliquerint	deliquerit
memoratarum	memoratorum
percipiente	percipientes
qualitate	qualitatem
deficient	deficiente
deficientes	deficiente
deficientem	deficiente
pereniter	perenniter
indulgencia	indulgentia
indulgencias	indulgentia
gloriosisimi	gloriosisime
gloriosisimo	gloriosisime
morabantur	morabatur
reciperet	reciperent
glocestria	gloucestria
dunstanuil	dunstanuila
dunestanuila	dunstanuila
posibilitate	posibilitatem
pendentibus	apendentibus
corexerint	porexerint
destinatis	destinati
uendicabit	uendicabat
uendicauit	uendicabat
leuekenore	leukenore
diligencia	diligentia
kerdington	erdington
transmiserunt	transmiserint
conuertendis	conuertendas
conuertendos	conuertenda
conuertendi	conuertenda
contentarum	contentorum
aduenientes	adueniente
obedienciarii	obedientiarii
inundatione	inundationem
inundationes	inundationem
admitendos	admitendus
admitendum	admitendam
ataciamento	ataciamenta
subrogentur	subrogetur
piscatore	piscatores
piscatorem	piscatorum
subiecimus	subicimus
metropolitice	metropolitica
consimiles	consimilem
consimile	consimilem
optinente	optinentes
calumniari	calumpniari
condaminas	condaminam
condamina	condaminam
condeminam	condaminam
extimatione	estimatione
petraponte	petrafonte
merliniaco	merleniaco
liberatum	libertatum
rectitudinis	rectitudines
confirmabo	confirmato
suggestionem	suggestione
postulabant	postulabat
obtinuerunt	optinuerunt
expedicionem	expedicione
comparaui	comparauit
westeweardne	westewearde
westeweardre	westewearde
herepathe	herepathes
defendentem	defendentes
iudicentur	iudicetur
conferent	conferente
conferentes	conferente
qualescumque	qualemcumque
qualemcunque	qualescumque
vocitamine	uocitamine
consecraui	consecrari
distributionis	distributiones
uarietatem	uarietate
tradiderit	tradiderint
tradiderat	tradiderint
luxouiensis	lexouiensis
colecestriam	colecestria
abendonensis	abendonensi
cognouerint	cognouerit
manuteneat	manuteneant
exequentur	exequetur
monasticum	monasticam
forefacti	forefactis
porexerunt	porexerint
adquietabit	acquietabit
acquietauit	adquietabit
aquietabit	acquietabit
edificauerit	edificauerint
soleniter	solemniter
posedisent	posediset
edificandas	edificandam
edificanda	edificandi
custodiendos	custodiendis
renuntiatum	renunciatum
satisfecerunt	satisfecerint
possidendi	posidenda
dublinensi	dublinensis
inueniendo	inueniendi
inueniendis	inueniendi
inuenienda	inueniendi
legauerint	legauerunt
fauconberg	faucunberg
gubernatione	gubernationem
prouiderint	prouiderent
prouenientia	prouenientis
proueniencia	prouenientis
asportauerint	asportauerunt
conuertendo	conuertenda
substitutus	substitutum
preficiendi	preficiendo
continentiam	continentia
adherentes	adherentem
adherente	adherentem
celebrantur	celebratur
excolatur	excolantur
inpedientes	impedientes
impetrationi	impetratione
impetrationem	impetratione
custumariis	custumarii
aprobationem	probationem
diuidendos	diuidendis
diuidendas	diuidendis
raginaldum	rainaldum
dimiterent	dimiteret
rupefortis	rupeforti
ioigniaci	iouigniaci
middeweardne	middewearde
middeweardre	middewearde
salutifera	salutifere
diuersorum	diuersarum
diversarum	diuersarum
sufragante	suffragante
destinandum	festinandum
munificencia	munificentia
sustinent	sustineant
declaratur	declaratum
retulerunt	detulerunt
impositione	impositionem
iniquitate	iniquitatem
construxerant	construxerat
construxerint	construxerunt
westminstre	westmynstre
westmunstre	westmynstre
acquiescere	adquiescere
superiore	superiorem
superiores	superiorem
maledictioni	maledictionis
stainforde	stainford
suplicatum	duplicatum
peregrinis	peregrini
constituant	constituat
constituunt	constituat
indiguerint	indiguerit
construxerit	construxerat
amonitionem	monitionem
permitemus	permitimus
autoritatem	autoritate
glecestra	glecestria
infangentef	infangenetef
infangetef	infangenteof
benedictam	benedictum
benedicta	benedictum
contempserit	contempserint
posteritate	posteritati
posteritatem	posteritati
confirmaret	confirmare
confirmarem	confirmare
pertinuerint	pertinuerit
testificari	testificati
testificata	testificati
colectione	corectione
elemosinariam	elemosinaria
modiationem	modiatione
impresentiarum	inpresentiarum
esiamentis	asiamentis
transferat	transfere
compensatione	compensationem
recipientur	recipietur
recipiuntur	recipietur
circumuenta	circumuenti
retinendis	retinendi
confirmabunt	confirmarunt
clerekenwel	clerekenewel
clerkenewel	clerekenewel
perdiderunt	perdiderint
quamplurium	quamplurimum
wiltescire	wiltesire
wiltesirie	wiltesire
basingeham	basingham
aquietandum	acquietandum
continentie	continente
continentis	continente
continencie	continente
deteriorentur	deterioretur
contradicit	contradicat
contradidit	contradidi
parmentarii	parmentario
marmaducus	marmeducus
asignandum	asignandam
acquietantia	acquietancia
acquietancie	acquietancia
acquietanciam	acquietancia
declaratione	declarationem
continere	contingere
faciendarum	faciendorum
servitutibus	seruitutibus
obseruanti	obseruantia
obseruati	obseruantia
obseruantie	obseruantia
citatione	citationem
citationes	citationem
brugewalteri	brugeswalteri
procuratorium	procuratorum
monesterio	monasterio
presbiteratu	presbiteratus
presbiteratum	presbiteratus
infrascripta	infrascriptas
infrascriptam	infrascriptum
ingelbertus	engelbertus
molismenses	molismensem
pruuinensium	pruuiniensium
deilocensis	deilocenses
adquisitione	acquisitione
acquisitionem	adquisitione
bryttannie	brittannie
consencientes	consentientes
eadbertus	eadberhtus
herefordense	herefordensem
supranominato	supranominata
supranominatam	supranominata
praedictae	praedicta
deuotissimo	devotissimo
ponerentur	poneretur
perpetrati	perpetrata
penitencie	penitencia
dcccclxii	dcccclxiii
dcccclxvii	dcccclxvi
redigatur	redigantur
acquisitum	adquisitum
deputetur	deputentur
computentur	computetur
comutetur	computetur
computatur	computetur
uicinitatem	uicinitate
waxtunesham	waxtonesham
instituatis	institutis
plenissime	plenisime
walkelinus	walcelinus
nortumberlanda	nortumberland
lincoliensi	lincolniensi
fiscanensi	fiscanensis
preceperat	receperat
prouenerint	prouenerit
excolendum	excolendam
herefordiam	herefordia
forestagio	forestario
permanerent	permaneret
clarembaudus	clarembaldus
redimendam	redimendum
pertinerent	pertineret
cancelariam	cancelaria
deuenirent	deuenient
querimonie	querimonia
decisione	decisionem
comoditate	comoditati
comoditates	comoditatem
decolationem	desolationem
soluerentur	solueretur
partiuntur	partientur
patientur	partientur
partiantur	patiantur
nostrosque	nostroque
procuratis	procuratio
asistentes	asistente
atemptauerint	atemptauerit
ampliandum	ampliandam
recusauerint	recusauerit
proueniet	prouenient
fretesente	fretesent
transeuntis	transeuntes
circumstanciis	circumstantiis
indemnitate	indempnitate
corectioni	corectionis
iudicandum	iudicandus
alwoldeston	alwaldeston
transgresionis	transgresiones
asentionis	ascentionis
asertionis	asertioni
contractas	contractus
contracta	contractus
bertrandum	bertrandus
dokelingtone	dokelintone
gausbertus	gaubertus
gauceranus	gausceranus
pruuinenses	pruuinienses
pruuiniensis	pruuinienses
pontigniaco	montigniaco
montiniaco	montigniaco
heubecort	heubecourt
condicionem	conditionem
arcebisceope	arcebisceopes
arcebiscopes	arcebisceopes
designata	designatam
designatum	designatur
custodiunt	custodiant
constituendo	constituendi
constituendis	constituendi
sublimitati	sublimitate
prelibatum	prelibatam
christianis	cristianis
hereditarias	hereditariis
exteriores	exteriorem
exactionum	exactionem
participum	participium
probauerint	probauerit
quadringentis	quadringentas
braclesham	bracklesham
redibitione	redibitiones
manifestis	manifestas
manifestius	manifestas
aqueductus	aqueductum
substitutos	substituto
heremanus	heremannus
exhibeatur	exhibetur
recipientem	recipientes
sacramentis	sacramenti
dunolmensi	dunelmensi
retinuerat	retinuerit
bercesira	bercescira
transmisi	transmisit
transmisis	transmisit
calumnias	calumpnias
pulsationem	pulsatione
cotidianam	cotidiana
parociano	parocianos
nortamton	nortampton
primogenitam	primogenitum
turonensi	turonensis
recipiebant	recipiebat
ostiensis	hostiensis
illustrium	ilustrium
comoditatis	comoditati
suceserint	suceserit
recuperauerint	recuperauerunt
rescripti	prescripti
inteligatur	inteligantur
forestarum	forestarium
wolgaricot	wolgaricote
wlgaricote	wolgaricote
deforciat	deforciant
conuenerit	conuenerat
sanctisimus	sanctisimum
compleantur	compleatur
instituantur	instituatur
liberandam	liberanda
exilitate	exilitatem
sepeliendi	sepelienda
sepeliendo	sepelienda
perpetuae	perpetuare
perpetrare	perpetuare
indigentiam	indigentium
amercientur	amercietur
legiptimas	legitimas
deliberaui	deliberauit
masingeham	masingham
bilingham	birlingham
constantinum	constantinus
distringit	distrinxit
munitionibus	monitionibus
admisionem	admisione
bucfestrie	bucfestria
deferente	deferentes
subdelegatus	subdelegatis
subdelegati	subdelegato
bolesouer	bolesouere
colcestria	colecestria
excipiendi	excipiendo
nominandam	nominandis
inferiores	inferioris
inferiore	inferioris
inferiorem	inferioris
aceptabunt	aceptarunt
profesorem	profesore
distributionum	distributionem
matisconem	matiscone
ermengarda	ermengarde
francisia	francisiam
regniacensi	regniacensis
regniacenses	regniacensis
parliamento	parlamento
mansionariis	mansionarii
naiarensi	naiarensis
nazarensis	naiarensis
garentizabunt	garantizabunt
abrenuntiantes	abrenunciantes
presidentis	presidentes
agentibus	augentibus
intemerate	intemerata
vicissitudine	vicissitudinem
placitanda	placitandi
collatione	collacione
certisime	certissime
silvarumque	siluarumque
expendantur	expendatur
relinquendam	relinquendum
anathematizatus	anatematizatus
hebdomadas	ebdomadas
tribulationes	tribulatione
inperpetuo	imperpetuo
easteweardne	eastewearde
fragilitati	fragilitatis
appellatiuo	appellativo
miserimus	miserrimus
restitutum	destitutum
doruernensis	dorouernensis
contineat	continebat
mildehale	mildenhale
procurandam	procuranda
constanciensis	constantiensis
constantiensi	constanciensis
pateretur	paterentur
windesores	windesore
proclamatione	proclamationem
exhibendos	exhibendo
intendebat	intendebant
conceseram	conceserat
latrocinii	latrocinio
statuendis	statuendi
submonitione	submonitionem
iusticiarium	iusticiarius
iusticiarum	iusticiarius
corigantur	coligantur
seruierint	seruierit
herfordensi	herefordensi
inuestiture	inuestitura
dilationi	dilationis
kirkesteda	kirkestede
posidentur	posideantur
perturbetur	perturbentur
rescripto	prescripto
audienciam	audientiam
audiencia	audientiam
conquerebantur	conquerebatur
redierimus	rediderimus
cornubiense	cornubiensi
cornubiensis	cornubiensi
transgresionum	transgresionem
hospitalarios	hospitalariis
hospitalarius	hospitalariis
prestecot	prestecote
solicitus	solicitius
wincecombe	wincecomb
wincecomba	wincecomb
turberuil	turberuile
turberuila	turberuile
detentionem	detentione
conferatur	conferantur
conferetur	conferantur
motesfonte	motesfont
imparcabuntur	inparcabuntur
distringatur	distringantur
coligendis	coligendi
coligenda	coligendas
coligendam	coligendas
delinquentes	relinquentes
spoliatione	spoliationem
impedient	impediente
insuficientia	insuficientie
distulerit	distulerint
impenditur	impendatur
destinatus	destinatis
perseuerauerunt	perseuerauerint
ratificabit	ratificauit
imunitatis	imunitates
sumeresham	someresham
cancelatum	cancelatam
transferet	transfere
claremunda	claremunde
inmobilibus	imobilibus
quietuclamaui	quietumclamaui
incorigibilem	incorigibiles
excomunicationum	excomunicationem
saluamenti	saluamento
claromontis	clarimontis
grimbaldus	grimaldus
transeundo	transfundo
festiuitatum	festiuitatem
uizeliacensi	uizeliacensis
fortalicias	fortalicia
pruliacensis	pruliacensi
maritandam	maritanda
clarambaudus	clarembaudus
cristinus	cristianus
uenditori	uenditoris
circonuenta	circonuenti
sampigneio	sampigneo
liberationibus	librationibus
liberalius	liberalibus
seruitutum	servitutum
antistitem	antistite
iminentibus	imminentibus
necessitatem	necesitatem
aquilonale	aquilonali
beniuolentie	beniuolentia
gloriosissimi	gloriosisimi
gloriosissimo	gloriosisimi
contestationem	contestatione
venationibus	uenationibus
constituatur	constituantur
constituetur	constituitur
exercetur	exerceatur
metropolitanum	metropolitana
commutatione	comutatione
apostolicarum	apostolicorum
beorhtwulf	beorhtulf
frequentia	frequenti
satisfaccionem	satisfactionem
comprobatum	comprobatur
comprobatus	comprobatur
comprobantur	comprobatur
promerendam	proferendam
winterborne	winterburne
respiciendo	despiciendo
districtam	districta
deseruierit	deseruerit
dccccxlvi	dccccxlvii
forisfacture	forisfactura
nitebantur	nitebatur
limitationem	imitationem
huntedonie	huntendonie
consolatione	consolationem
precedentis	precedenti
restituerit	restitueret
conestabulus	constabulus
quietationes	quietationem
salopesberiam	salopesberia
propinqua	propinquam
protestantur	protestatur
conestabularii	constabularii
guarantizare	garantizare
subtrahantur	subtrahatur
deuoluetur	deuoluentur
acreuerint	creuerint
uocationem	uocatione
uocationes	uocatione
denuntiamus	renuntiamus
rauenswarte	rauenswart
dorkecestrie	dorkecestria
adquietauit	adquietabit
euocauimus	uocauimus
manaserius	manaserus
fauorabilem	fauorabiles
ocupatione	ocupationem
castelario	castelaria
claudendas	claudendam
protestati	potestati
suscitentur	suscitetur
purpresturam	purprestura
rieualensis	rieualensi
transgresu	transgresus
fungebatur	fungebamur
intromitent	intromitant
bolington	bolingtona
denuncietis	denuntietis
interposui	interposuit
conseruando	conseruanda
conseruande	conseruanda
bitlesdene	bitlisdene
preueniente	proueniente
obseruauerint	obseruauerit
conuentrensi	couentrensi
familiarum	familiares
infirmariam	infirmaria
goldingham	coldingham
apropriate	apropriare
subtraxerit	subtraxerint
conferendis	conferendi
normanuile	normanuil
burdegalensi	burdegalensis
lateranensi	lateranensis
tingehurst	tinghurst
receptore	preceptore
receptores	preceptoris
indenturam	indentura
warantizauerint	warantizauerit
coadiutorem	coadiutores
coadiutoris	coadiutores
omiserint	comiserint
rikinghal	rikingehal
penitenciario	penitentiario
restituentur	restituantur
adquietationis	acquietationis
sacerdocii	sacerdotii
uiolencia	uiolenciam
conuentuales	conuentualis
concedentis	concedentes
licefeldens	licefelden
renuntiarunt	renunciarunt
cauncefelde	cancefelde
florentio	florentino
contempsit	contempnit
forestariam	forestarium
computatione	comutatione
exhibitorem	exhibitores
molestarent	molestaret
dominicatum	dominicatu
flauiniaci	flauigniaci
calumpniabant	calumpniabat
calumpniabar	calumniabar
uirsionenses	uirsionensis
herembertus	herebertus
petragoricensi	petragoricensis
giniacensis	gigniacensis
castriduno	castriduni
claustralem	claustrales
successori	successor
sequestratum	sequestratus
sequestramus	sequestratus
conflictum	conflictu
ecclesiasticarum	eclesiasticarum
donacione	donacionem
inuisibilia	invisibilia
monastica	monasticam
constituentur	constituantur
perdonaui	perdonauit
nominandis	nominandi
praesenti	praesentis
stabilimus	stabilius
conscriptum	conscriptam
ethelheardi	ethelheard
metropolitanam	metropolitana
emendacione	emendatione
celeberrima	celeberrimo
brittanie	brittannie
positionem	apositionem
culpabiles	culpabilem
dcccxliiii	dcccliiii
dcccxxiiii	dcclxxiiii
patiuntur	partiuntur
atribuimus	tribuimus
ethelwulfus	etheluulfus
ethelberht	ethelbearht
comparationem	comparatione
comparatum	comparatam
reseruetur	reseruentur
habeantque	habeatque
aethelgeard	ethelgeard
comprehensam	comprehensa
witlesmare	witlesmere
inuenientur	inueniantur
premonitus	premunitus
responsionem	responsione
confirmetis	confirmatis
instituant	instituent
hermitagium	heremitagium
hermentrudis	ermentrudis
transferatur	transferantur
infractionem	infractione
redebatur	redebantur
lancastra	lancastria
abundantia	habundantia
perficienda	perficiendas
sauigniaco	sauiniaco
cestretone	cestreton
clarembaudi	clarembaldi
impetrabimus	impetrauimus
decimandi	decimandis
aramburgis	aremburgis
blecesdon	blecesdone
construent	construet
combustione	combustionem
renuntiatione	renuntiationem
renuntiationi	renuntiationem
retinenda	retinendam
retinendas	retinendam
consentaneus	consentaneum
melceburne	meldeburne
kokerington	cokerington
requisierit	requisierint
crucesignatus	crucesignatis
mclxxxxiiii	mclxxxiiii
edificando	edificandi
longespeie	lungespeie
maritandum	maritandam
uicecomitisa	uicecomitis
comendatam	comendatum
singilatim	sigilatim
continuata	continuato
columbarium	columbarum
malmesburiensi	malmesburiensis
deliberandam	deliberandum
camerarum	camerarium
cardinale	cardinalem
comitendam	comitenda
comitendas	comitenda
deteriorationem	deterioratione
celerariam	celeraria
contraria	contrariam
implacitari	inplacitari
inplacitati	inplacitari
stapenhule	stapenhul
norhamtonie	norhamptonie
ordinaret	ordinarent
ordinarunt	ordinabunt
cotidianum	cotidianam
dirigentes	diligentes
procuretur	procurentur
inpresionem	inpresione
exemplari	exemplario
examinato	examinatos
seperabili	separabili
bonefatius	bonifatius
reducantur	reducuntur
goldesboruh	goldesborug
taliabilem	taliabiles
taliabilis	taliabiles
tailiabiles	taliabiles
trescentum	trecentum
submisiones	submisionis
submisione	submisionem
edificauerunt	edificauerint
camberlein	camberlain
uisitantes	uisitante
respondendo	respondendi
reseruatione	reseruationem
renunciat	renunciant
beliocensi	beliocensis
pilibertus	filibertus
acipiebant	acipiebat
beluacense	beluacensem
arcembaudus	arcambaudus
confluentio	conflentio
branciduno	branciduni
flauigniacum	flauiniacum
redonensis	ledonensis
columbenses	columbensis
altisiodoro	autisiodoro
corbigniaci	corbigniaco
corbiniaco	corbigniaco
belilarici	belilarico
sergentariam	sergenteriam
apenditias	apenditiis
apenditia	apenditiis
prestantis	prestandis
damnationem	dampnationem
uelocitate	velocitate
ethelrede	ethelredes
ecclesiasticum	eclesiasticum
congregari	congregati
genetrici	genetricis
reverentia	reuerentia
descendat	descendant
uoluntatum	uoluntatem
cogitationes	cogitatione
sanctissime	sanctisime
christiano	cristiano
dubitationem	dubitatione
monumentum	monimentum
designati	designatis
defraudari	defraudare
curiculis	curriculis
consentit	consentiat
ealdormen	ealdormenn
emendarent	emendaret
haereditatem	hereditatem
munitionis	munitiones
dccccxliiii	dccccxlviii
aprehensione	apprehensione
firmauerit	firmauerat
relaxentur	relaxetur
idemestone	idemeston
multoties	multotiens
meldeburna	meldeburne
meleburne	meldeburne
meldeburn	meldeburne
liberarent	liberaret
cristianum	cristianam
deferentur	deferetur
sarisberiensis	saresberiensis
sarisburiensis	saresberiensis
roucestre	froucestre
gilingeham	gilingham
ocupauerant	ocupauerat
tractentur	tractetur
salesberiensis	saresberiensis
pictauiensi	pictauiensis
auctentici	auctentico
reputabuntur	deputabuntur
infangeteof	infangenteof
malmesberie	malmesburie
depositiones	depositionis
obtinendum	obtinendam
acipientur	acipietur
retinerent	retineret
uicissitudine	uicisitudine
excambiaui	excambiauit
clericali	clericalis
apreciatus	apreciatum
destinatas	destinatis
instauramento	instauramenta
reficiendam	reficiendas
cristescerce	cristescurce
interpretatione	interpretationem
atestationis	atestationes
indubitata	indubitatam
percepturum	percepturus
suscipiendam	suscipiendum
conuertetur	conuertatur
meneuensi	meneuensis
presentaset	presentase
presentasent	presentase
witlingham	wiflingham
conquestione	conquestionem
cliuelandie	cliuelande
pecuniariam	pecuniaria
pecuniarias	pecuniaria
castelariam	castelaria
meridionali	meridionalis
quadrantis	quadrantes
bertolomeo	bartolomeo
emendandis	emendandi
pokelington	pokelinton
leisingbi	leisingebi
negligentie	negligentia
prouenerunt	prouenerint
presentauerit	presentauerint
relinquitur	relinquatur
agriculture	agricultura
contulisent	contuliset
pretermiso	pretermisa
corigatur	corigantur
carnifice	carnifices
lesington	plesington
percipientur	percipietur
inpignorare	impignorare
computandos	computandis
computandas	computandis
exemptionem	exemptione
carectario	carectarii
executori	executoris
executorio	executoris
obseruatis	obseruetis
nominationis	dominationis
diuiderentur	diuideretur
guerpitionem	uuerpitionem
obtinerent	obtineret
uenerandum	uenerandus
arcipresbiteris	arcipresbiteri
marigniaco	maigniaco
pruuinensibus	pruuiniensibus
expendentur	expendantur
piatouilari	piatiuilari
construitur	construatur
condempnatum	condempnatus
comparavit	comparauit
possidenda	posidenda
cyrographo	cyrographi
destinatum	destinatus
occidentale	occidentali
adquietationem	adquietatione
conpetentem	competentem
eleemosynam	eleemosinam
estimacione	estimatione
donacioni	donacionis
emendaverint	emendaverit
prememoratam	prememorata
relinquens	delinquens
kingestun	kingestune
concedamus	concedimus
concedemus	concedimus
scribentur	scribuntur
inmortalitatis	immortalitatis
wincelcumbe	wincecumbe
brittanniae	brittannie
brittannice	brittannie
brittannia	brittannie
ufeweardne	ufewearde
dorobonensis	dorobornensis
procurarent	procurarunt
dulcedine	dulcedinem
ethelwoldus	athelwoldus
wulfstane	wulfstanes
westmynster	westminster
landgemare	landgemere
subiciantur	subiciatur
dcccclxxiiii	dcccclxiii
uigilantia	uigilanti
simplingham	semplingham
aecclesiarum	ecclesiarum
quarumcunque	quorumcunque
liberalis	liberalius
infangenethef	infangenetef
miskeninge	miskenninge
breuitate	breuitatem
consequuntur	consequantur
habundanter	abundanter
consecrase	consecrate
constanciensi	constanciensis
baldwinum	baldewinum
antiquioris	antiquiores
antiquiorem	antiquiores
qualescunque	qualescumque
conestabulo	constabulo
parasceues	parasceue
adquisitionem	adquisitione
adquisitiones	adquisitione
requirerent	requireret
friteswite	frideswite
disensionem	disensiones
contineantur	continentur
preparetur	reparetur
sumonitionis	sumonitiones
suficiencia	suficientia
fincingfeld	fincingefeld
aministratione	administratione
aparuerunt	aparuerint
apertinenciis	pertinenciis
atemptarent	atemptaret
mikeltwait	mikeltuait
huntedone	huntedonie
bridlingtona	bridlintona
deceserunt	deceserint
ulkertorpe	ulkertorp
hierosolimitanum	ierosolimitanum
imperatorem	imperatore
imperatorum	imperatore
rocelinus	roscelinus
presumpserunt	presumpserint
norwicens	norwicensi
leuekenor	leuekenore
aplicetur	aplicentur
licesfeldensi	licefeldensi
implacitare	implacitari
faucumberg	faucunberg
concordant	concordat
acedentibus	cedentibus
perueniset	perueniret
admiserunt	amiserunt
concesionum	concesionem
spectabunt	spectabant
compeletur	compelatur
deferantur	deferatur
admitendo	admitendos
construendis	construendi
destitutione	restitutione
ancelinus	lancelinus
asignantur	asignentur
impetrabunt	impetrarunt
comunicant	comunicent
fructuosam	fructuosa
citationis	citationes
clericale	clericalem
cumbermare	cumbermar
comparenti	comparente
insuficientes	insuficientem
proferendum	proferendam
postulationi	postulationis
seruituro	seruituros
literature	literatura
procurandi	procuranda
cirograpatis	cirograpati
negligencia	negligentia
beniuolencia	beniuolentia
salfletebi	salfletbi
equitaturas	equitaturis
contentionum	contentionem
percepimus	percipimus
contumacie	contumacia
prolationem	probationem
excludamur	excludatur
excluditur	excludatur
detinuerint	retinuerint
prosequatur	prosequamur
consueuiset	consueuisent
arbitratorum	arbitratorem
ihesucristi	iesucristi
pascentibus	poscentibus
suplicauerint	suplicauerunt
garentizare	garantizare
iuriditioni	iuridictioni
procuraturum	procuratorum
excommunicatus	excomunicatus
beatissimo	beatissimi
forisfacturis	forisfacturas
nominandas	nominandis
nominandos	nominandis
potestatum	potestatem
coepiscopis	cepiscopis
corroborare	coroborare
remissionem	remisionem
spiritalis	spiritualis
uicissitudo	vicissitudo
expeditionum	expeditionem
exigebantur	exigebatur
studuerunt	studuerint
temtaverit	temptaverit
aethelheah	ethelheah
celebratum	celebratam
concessionem	concesionem
generationem	uenerationem
hereforda	herefordia
aethelwlf	aethelwulf
etheredes	ethelredes
supramemoratas	supramemorata
abominando	abhominando
concurrentes	concurentes
superuenerint	superuenerit
deseruiens	deseruient
euangelicam	euangelica
redolentes	redolente
altitrono	altithrono
concesserat	conceserat
dcccclxiiii	dcccclxiii
peruenient	perueniens
subiacent	subiaceant
reinbaldus	reinaldus
suficientiam	suficientia
queninton	quenintone
wiltescira	wiltescire
constrictus	constrictum
terminentur	terminetur
dunholmensis	dunolmensis
windelsores	windesores
infongenetef	infangenetef
uiridarii	uiridariis
sarisbiriensi	saresbiriensi
comprehensum	comprehensam
aduersari	aduersario
bedefordia	bedefordie
precepistis	recepistis
dinoscimus	dinoscimur
apreciatas	apreciatus
restitutus	restitutum
persorensi	persorensis
exhibeantur	exhibeatur
presentandos	presentandus
solempnitatis	solempnitates
guarnerus	guarnerius
iustitiarios	iustitiariis
familiarem	familiares
presentauimus	presentabimus
confirmandis	confirmandas
celebrant	celebranti
walkelinum	walkelinus
dorkecestre	dorkecestrie
dorkecestr	dorkecestrie
inuenisemus	inueniemus
percipiens	percipient
conuocationes	conuocationem
fidedigni	fidedignis
distribuendi	distribuendis
exercebit	excercebit
uiolentas	uiolentias
subtrahuntur	subtrahantur
receptoris	preceptoris
deseruienti	deseruient
concedantur	concedatur
subiectionum	subiectionem
nominauimus	nominabimus
consuetudinarios	consuetudinario
hindolueston	hildolueston
consciencie	consciencia
compleuerit	compleuerint
leuauerint	leuauerit
conseruationi	conseruatione
adquietancie	acquietancie
obseruancias	obseruanciam
cognoscunt	cognoscant
portitorem	portitores
confitente	confitentes
ocupauerunt	ocupauerant
adquisiuerunt	adquisierunt
custodirent	custodient
montaniaco	montiniaco
ingelberti	engelberti
ispaniarum	hispaniarum
deseruirent	deseruient
tricenarii	tricenaria
castelane	castelanie
sanctisma	sanctisima
parisiens	parisiensi
pertinencias	pertinenciis
iuriditionem	iuridictionem
